Purchase Date,Financial Accounting,Item Category,Item,Net Quantity,Net Price,Sub Total,Total Discount,COGS,Profit
07/21/24,Food,Food,Takoyaki,3,10000,30000,0,24000,6000
07/21/24,Food,Food,Steak,4,60000,240000,0,220000,20000
07/21/24,Food,Food,Rendang,1,10000,10000,0,8000,2000
07/21/24,Food,Food,Fried Chicken,10,3000,30000,0,20000,10000
07/21/24,Food,Food,Noodles,8,6000,48000,0,40000,8000
07/21/24,Food,Food,Salmon,4,15000,60000,0,56000,4000
07/21/24,Food,Food,Macaroni,1,5000,5000,0,4000,1000
07/21/24,Food,Food,Fish & Chips,3,30000,90000,0,81000,9000
07/21/24,Food,Food,Burger,2,15000,30000,0,28000,2000
07/21/24,Food,Food,Hotdog,3,10000,30000,0,27000,3000
07/21/24,Food,Food,Pasta,1,18000,18000,0,16000,2000
07/21/24,Food,Snack,Chips,2,5000,10000,0,8000,2000
07/21/24,Food,Snack,Popcorn,1,7000,7000,0,6500,500
07/21/24,Food,Snack,Almonds,1,8000,8000,0,7000,1000
07/21/24,Food,Beverages,Lemon Tea,5,4000,20000,0,15000,5000
07/21/24,Food,Beverages,Ocha,2,4000,8000,0,7000,1000
07/21/24,Food,Beverages,Lychee Tea,3,6000,18000,0,15000,3000
07/21/24,Food,Beverages,Oolong Tea,1,6000,6000,0,5000,1000
07/21/24,Food,Beverages,Soda,3,5000,15000,0,12000,3000
07/22/24,Food,Food,Takoyaki,3,10000,30000,0,24000,6000
07/22/24,Food,Food,Steak,4,60000,240000,0,220000,20000
07/22/24,Food,Food,Rendang,1,10000,10000,0,8000,2000
07/22/24,Food,Food,Fried Chicken,10,3000,30000,0,20000,10000
07/22/24,Food,Food,Noodles,8,6000,48000,0,40000,8000
07/22/24,Food,Food,Salmon,4,15000,60000,0,56000,4000
07/22/24,Food,Food,Macaroni,1,5000,5000,0,4000,1000
07/22/24,Food,Food,Fish & Chips,3,30000,90000,0,81000,9000
07/22/24,Food,Food,Burger,2,15000,30000,0,28000,2000
07/22/24,Food,Food,Hotdog,3,10000,30000,0,27000,3000
07/22/24,Food,Food,Pasta,1,18000,18000,0,16000,2000
07/22/24,Food,Snack,Chips,2,5000,10000,0,8000,2000
07/22/24,Food,Snack,Popcorn,1,7000,7000,0,6500,500
07/22/24,Food,Snack,Almonds,1,8000,8000,0,7000,1000
07/22/24,Food,Beverages,Lemon Tea,5,4000,20000,0,15000,5000
07/22/24,Food,Beverages,Ocha,2,4000,8000,0,7000,1000
07/22/24,Food,Beverages,Lychee Tea,3,6000,18000,0,15000,3000
07/22/24,Food,Beverages,Oolong Tea,1,6000,6000,0,5000,1000
07/22/24,Food,Beverages,Soda,3,5000,15000,0,12000,3000
07/23/24,Food,Food,Takoyaki,3,10000,30000,0,24000,6000
07/23/24,Food,Food,Steak,4,60000,240000,0,220000,20000
07/23/24,Food,Food,Rendang,1,10000,10000,0,8000,2000
07/23/24,Food,Food,Fried Chicken,10,3000,30000,0,20000,10000
07/23/24,Food,Food,Noodles,8,6000,48000,0,40000,8000
07/23/24,Food,Food,Salmon,4,15000,60000,0,56000,4000
07/23/24,Food,Food,Macaroni,1,5000,5000,0,4000,1000
07/23/24,Food,Food,Fish & Chips,3,30000,90000,0,81000,9000
07/23/24,Food,Food,Burger,2,15000,30000,0,28000,2000
07/23/24,Food,Food,Hotdog,3,10000,30000,0,27000,3000
07/23/24,Food,Food,Pasta,1,18000,18000,0,16000,2000
07/23/24,Food,Snack,Chips,2,5000,10000,0,8000,2000
07/23/24,Food,Snack,Popcorn,1,7000,7000,0,6500,500
07/23/24,Food,Snack,Almonds,1,8000,8000,0,7000,1000
07/23/24,Food,Beverages,Lemon Tea,5,4000,20000,0,15000,5000
07/23/24,Food,Beverages,Ocha,2,4000,8000,0,7000,1000
07/23/24,Food,Beverages,Lychee Tea,3,6000,18000,0,15000,3000
07/23/24,Food,Beverages,Oolong Tea,1,6000,6000,0,5000,1000
07/23/24,Food,Beverages,Soda,3,5000,15000,0,12000,3000
07/24/24,Food,Food,Takoyaki,3,10000,30000,0,24000,6000
07/24/24,Food,Food,Steak,4,60000,240000,0,220000,20000
07/24/24,Food,Food,Rendang,1,10000,10000,0,8000,2000
07/24/24,Food,Food,Fried Chicken,10,3000,30000,0,20000,10000
07/24/24,Food,Food,Noodles,8,6000,48000,0,40000,8000
07/24/24,Food,Food,Salmon,4,15000,60000,0,56000,4000
07/24/24,Food,Food,Macaroni,1,5000,5000,0,4000,1000
07/24/24,Food,Food,Fish & Chips,3,30000,90000,0,81000,9000
07/24/24,Food,Food,Burger,2,15000,30000,0,28000,2000
07/24/24,Food,Food,Hotdog,3,10000,30000,0,27000,3000
07/24/24,Food,Food,Pasta,1,18000,18000,0,16000,2000
07/24/24,Food,Snack,Chips,2,5000,10000,0,8000,2000
07/24/24,Food,Snack,Popcorn,1,7000,7000,0,6500,500
07/24/24,Food,Snack,Almonds,1,8000,8000,0,7000,1000
07/24/24,Food,Beverages,Lemon Tea,5,4000,20000,0,15000,5000
07/24/24,Food,Beverages,Ocha,2,4000,8000,0,7000,1000
07/24/24,Food,Beverages,Lychee Tea,3,6000,18000,0,15000,3000
07/24/24,Food,Beverages,Oolong Tea,1,6000,6000,0,5000,1000
07/24/24,Food,Beverages,Soda,3,5000,15000,0,12000,3000
07/25/24,Food,Food,Takoyaki,3,10000,30000,0,24000,6000
07/25/24,Food,Food,Steak,4,60000,240000,0,220000,20000
07/25/24,Food,Food,Rendang,1,10000,10000,0,8000,2000
07/25/24,Food,Food,Fried Chicken,10,3000,30000,0,20000,10000
07/25/24,Food,Food,Noodles,8,6000,48000,0,40000,8000
07/25/24,Food,Food,Salmon,4,15000,60000,0,56000,4000
07/25/24,Food,Food,Macaroni,1,5000,5000,0,4000,1000
07/25/24,Food,Food,Fish & Chips,3,30000,90000,0,81000,9000
07/25/24,Food,Food,Burger,2,15000,30000,0,28000,2000
07/25/24,Food,Food,Hotdog,3,10000,30000,0,27000,3000
07/25/24,Food,Food,Pasta,1,18000,18000,0,16000,2000
07/25/24,Food,Snack,Chips,2,5000,10000,0,8000,2000
07/25/24,Food,Snack,Popcorn,1,7000,7000,0,6500,500
07/25/24,Food,Snack,Almonds,1,8000,8000,0,7000,1000
07/25/24,Food,Beverages,Lemon Tea,5,4000,20000,0,15000,5000
07/25/24,Food,Beverages,Ocha,2,4000,8000,0,7000,1000
07/25/24,Food,Beverages,Lychee Tea,3,6000,18000,0,15000,3000
07/25/24,Food,Beverages,Oolong Tea,1,6000,6000,0,5000,1000
07/25/24,Food,Beverages,Soda,3,5000,15000,0,12000,3000
07/26/24,Food,Food,Takoyaki,3,10000,30000,0,24000,6000
07/26/24,Food,Food,Steak,4,60000,240000,0,220000,20000
07/26/24,Food,Food,Rendang,1,10000,10000,0,8000,2000
07/26/24,Food,Food,Fried Chicken,10,3000,30000,0,20000,10000
07/26/24,Food,Food,Noodles,8,6000,48000,0,40000,8000
07/26/24,Food,Food,Salmon,4,15000,60000,0,56000,4000
07/26/24,Food,Food,Macaroni,1,5000,5000,0,4000,1000
07/26/24,Food,Food,Fish & Chips,3,30000,90000,0,81000,9000
07/26/24,Food,Food,Burger,2,15000,30000,0,28000,2000
07/26/24,Food,Food,Hotdog,3,10000,30000,0,27000,3000
07/26/24,Food,Food,Pasta,1,18000,18000,0,16000,2000
07/26/24,Food,Snack,Chips,2,5000,10000,0,8000,2000
07/26/24,Food,Snack,Popcorn,1,7000,7000,0,6500,500
07/26/24,Food,Snack,Almonds,1,8000,8000,0,7000,1000
07/26/24,Food,Beverages,Lemon Tea,5,4000,20000,0,15000,5000
07/26/24,Food,Beverages,Ocha,2,4000,8000,0,7000,1000
07/26/24,Food,Beverages,Lychee Tea,3,6000,18000,0,15000,3000
07/26/24,Food,Beverages,Oolong Tea,1,6000,6000,0,5000,1000
07/26/24,Food,Beverages,Soda,3,5000,15000,0,12000,3000
07/27/24,Food,Food,Takoyaki,3,10000,30000,0,24000,6000
07/27/24,Food,Food,Steak,4,60000,240000,0,220000,20000
07/27/24,Food,Food,Rendang,1,10000,10000,0,8000,2000
07/27/24,Food,Food,Fried Chicken,10,3000,30000,0,20000,10000
07/27/24,Food,Food,Noodles,8,6000,48000,0,40000,8000
07/27/24,Food,Food,Salmon,4,15000,60000,0,56000,4000
07/27/24,Food,Food,Macaroni,1,5000,5000,0,4000,1000
07/27/24,Food,Food,Fish & Chips,3,30000,90000,0,81000,9000
07/27/24,Food,Food,Burger,2,15000,30000,0,28000,2000
07/27/24,Food,Food,Hotdog,3,10000,30000,0,27000,3000
07/27/24,Food,Food,Pasta,1,18000,18000,0,16000,2000
07/27/24,Food,Snack,Chips,2,5000,10000,0,8000,2000
07/27/24,Food,Snack,Popcorn,1,7000,7000,0,6500,500
07/27/24,Food,Snack,Almonds,1,8000,8000,0,7000,1000
07/27/24,Food,Beverages,Lemon Tea,5,4000,20000,0,15000,5000
07/27/24,Food,Beverages,Ocha,2,4000,8000,0,7000,1000
07/27/24,Food,Beverages,Lychee Tea,3,6000,18000,0,15000,3000
07/27/24,Food,Beverages,Oolong Tea,1,6000,6000,0,5000,1000
07/27/24,Food,Beverages,Soda,3,5000,15000,0,12000,3000
07/28/24,Food,Food,Takoyaki,3,10000,30000,0,24000,6000
07/28/24,Food,Food,Steak,4,60000,240000,0,220000,20000
07/28/24,Food,Food,Rendang,1,10000,10000,0,8000,2000
07/28/24,Food,Food,Fried Chicken,10,3000,30000,0,20000,10000
07/28/24,Food,Food,Noodles,8,6000,48000,0,40000,8000
07/28/24,Food,Food,Salmon,4,15000,60000,0,56000,4000
07/28/24,Food,Food,Macaroni,1,5000,5000,0,4000,1000
07/28/24,Food,Food,Fish & Chips,3,30000,90000,0,81000,9000
07/28/24,Food,Food,Burger,2,15000,30000,0,28000,2000
07/28/24,Food,Food,Hotdog,3,10000,30000,0,27000,3000
07/28/24,Food,Food,Pasta,1,18000,18000,0,16000,2000
07/28/24,Food,Snack,Chips,2,5000,10000,0,8000,2000
07/28/24,Food,Snack,Popcorn,1,7000,7000,0,6500,500
07/28/24,Food,Snack,Almonds,1,8000,8000,0,7000,1000
07/28/24,Food,Beverages,Lemon Tea,5,4000,20000,0,15000,5000
07/28/24,Food,Beverages,Ocha,2,4000,8000,0,7000,1000
07/28/24,Food,Beverages,Lychee Tea,3,6000,18000,0,15000,3000
07/28/24,Food,Beverages,Oolong Tea,1,6000,6000,0,5000,1000
07/28/24,Food,Beverages,Soda,3,5000,15000,0,12000,3000
07/29/24,Food,Food,Takoyaki,3,10000,30000,0,24000,6000
07/29/24,Food,Food,Steak,4,60000,240000,0,220000,20000
07/29/24,Food,Food,Rendang,1,10000,10000,0,8000,2000
07/29/24,Food,Food,Fried Chicken,10,3000,30000,0,20000,10000
07/29/24,Food,Food,Noodles,8,6000,48000,0,40000,8000
07/29/24,Food,Food,Salmon,4,15000,60000,0,56000,4000
07/29/24,Food,Food,Macaroni,1,5000,5000,0,4000,1000
07/29/24,Food,Food,Fish & Chips,3,30000,90000,0,81000,9000
07/29/24,Food,Food,Burger,2,15000,30000,0,28000,2000
07/29/24,Food,Food,Hotdog,3,10000,30000,0,27000,3000
07/29/24,Food,Food,Pasta,1,18000,18000,0,16000,2000
07/29/24,Food,Snack,Chips,2,5000,10000,0,8000,2000
07/29/24,Food,Snack,Popcorn,1,7000,7000,0,6500,500
07/29/24,Food,Snack,Almonds,1,8000,8000,0,7000,1000
07/29/24,Food,Beverages,Lemon Tea,5,4000,20000,0,15000,5000
07/29/24,Food,Beverages,Ocha,2,4000,8000,0,7000,1000
07/29/24,Food,Beverages,Lychee Tea,3,6000,18000,0,15000,3000
07/29/24,Food,Beverages,Oolong Tea,1,6000,6000,0,5000,1000
07/29/24,Food,Beverages,Soda,3,5000,15000,0,12000,3000
07/30/24,Food,Food,Takoyaki,3,10000,30000,0,24000,6000
07/30/24,Food,Food,Steak,4,60000,240000,0,220000,20000
07/30/24,Food,Food,Rendang,1,10000,10000,0,8000,2000
07/30/24,Food,Food,Fried Chicken,10,3000,30000,0,20000,10000
07/30/24,Food,Food,Noodles,8,6000,48000,0,40000,8000
07/30/24,Food,Food,Salmon,4,15000,60000,0,56000,4000
07/30/24,Food,Food,Macaroni,1,5000,5000,0,4000,1000
07/30/24,Food,Food,Fish & Chips,3,30000,90000,0,81000,9000
07/30/24,Food,Food,Burger,2,15000,30000,0,28000,2000
07/30/24,Food,Food,Hotdog,3,10000,30000,0,27000,3000
07/30/24,Food,Food,Pasta,1,18000,18000,0,16000,2000
07/30/24,Food,Snack,Chips,2,5000,10000,0,8000,2000
07/30/24,Food,Snack,Popcorn,1,7000,7000,0,6500,500
07/30/24,Food,Snack,Almonds,1,8000,8000,0,7000,1000
07/30/24,Food,Beverages,Lemon Tea,5,4000,20000,0,15000,5000
07/30/24,Food,Beverages,Ocha,2,4000,8000,0,7000,1000
07/30/24,Food,Beverages,Lychee Tea,3,6000,18000,0,15000,3000
07/30/24,Food,Beverages,Oolong Tea,1,6000,6000,0,5000,1000
07/30/24,Food,Beverages,Soda,3,5000,15000,0,12000,3000
07/31/24,Food,Food,Takoyaki,3,10000,30000,0,24000,6000
07/31/24,Food,Food,Steak,4,60000,240000,0,220000,20000
07/31/24,Food,Food,Rendang,1,10000,10000,0,8000,2000
07/31/24,Food,Food,Fried Chicken,10,3000,30000,0,20000,10000
07/31/24,Food,Food,Noodles,8,6000,48000,0,40000,8000
07/31/24,Food,Food,Salmon,4,15000,60000,0,56000,4000
07/31/24,Food,Food,Macaroni,1,5000,5000,0,4000,1000
07/31/24,Food,Food,Fish & Chips,3,30000,90000,0,81000,9000
07/31/24,Food,Food,Burger,2,15000,30000,0,28000,2000
07/31/24,Food,Food,Hotdog,3,10000,30000,0,27000,3000
07/31/24,Food,Food,Pasta,1,18000,18000,0,16000,2000
07/31/24,Food,Snack,Chips,2,5000,10000,0,8000,2000
07/31/24,Food,Snack,Popcorn,1,7000,7000,0,6500,500
07/31/24,Food,Snack,Almonds,1,8000,8000,0,7000,1000
07/31/24,Food,Beverages,Lemon Tea,5,4000,20000,0,15000,5000
07/31/24,Food,Beverages,Ocha,2,4000,8000,0,7000,1000
07/31/24,Food,Beverages,Lychee Tea,3,6000,18000,0,15000,3000
07/31/24,Food,Beverages,Oolong Tea,1,6000,6000,0,5000,1000
07/31/24,Food,Beverages,Soda,3,5000,15000,0,12000,3000
08/01/24,Food,Food,Takoyaki,3,10000,30000,0,24000,6000
08/01/24,Food,Food,Steak,4,60000,240000,0,220000,20000
08/01/24,Food,Food,Rendang,1,10000,10000,0,8000,2000
08/01/24,Food,Food,Fried Chicken,10,3000,30000,0,20000,10000
08/01/24,Food,Food,Noodles,8,6000,48000,0,40000,8000
08/01/24,Food,Food,Salmon,4,15000,60000,0,56000,4000
08/01/24,Food,Food,Macaroni,1,5000,5000,0,4000,1000
08/01/24,Food,Food,Fish & Chips,3,30000,90000,0,81000,9000
08/01/24,Food,Food,Burger,2,15000,30000,0,28000,2000
08/01/24,Food,Food,Hotdog,3,10000,30000,0,27000,3000
08/01/24,Food,Food,Pasta,1,18000,18000,0,16000,2000
08/01/24,Food,Snack,Chips,2,5000,10000,0,8000,2000
08/01/24,Food,Snack,Popcorn,1,7000,7000,0,6500,500
08/01/24,Food,Snack,Almonds,1,8000,8000,0,7000,1000
08/01/24,Food,Beverages,Lemon Tea,5,4000,20000,0,15000,5000
08/01/24,Food,Beverages,Ocha,2,4000,8000,0,7000,1000
08/01/24,Food,Beverages,Lychee Tea,3,6000,18000,0,15000,3000
08/01/24,Food,Beverages,Oolong Tea,1,6000,6000,0,5000,1000
08/01/24,Food,Beverages,Soda,3,5000,15000,0,12000,3000
08/02/24,Food,Food,Takoyaki,3,10000,30000,0,24000,6000
08/02/24,Food,Food,Steak,4,60000,240000,0,220000,20000
08/02/24,Food,Food,Rendang,1,10000,10000,0,8000,2000
08/02/24,Food,Food,Fried Chicken,10,3000,30000,0,20000,10000
08/02/24,Food,Food,Noodles,8,6000,48000,0,40000,8000
08/02/24,Food,Food,Salmon,4,15000,60000,0,56000,4000
08/02/24,Food,Food,Macaroni,1,5000,5000,0,4000,1000
08/02/24,Food,Food,Fish & Chips,3,30000,90000,0,81000,9000
08/02/24,Food,Food,Burger,2,15000,30000,0,28000,2000
08/02/24,Food,Food,Hotdog,3,10000,30000,0,27000,3000
08/02/24,Food,Food,Pasta,1,18000,18000,0,16000,2000
08/02/24,Food,Snack,Chips,2,5000,10000,0,8000,2000
08/02/24,Food,Snack,Popcorn,1,7000,7000,0,6500,500
08/02/24,Food,Snack,Almonds,1,8000,8000,0,7000,1000
08/02/24,Food,Beverages,Lemon Tea,5,4000,20000,0,15000,5000
08/02/24,Food,Beverages,Ocha,2,4000,8000,0,7000,1000
08/02/24,Food,Beverages,Lychee Tea,3,6000,18000,0,15000,3000
08/02/24,Food,Beverages,Oolong Tea,1,6000,6000,0,5000,1000
08/02/24,Food,Beverages,Soda,3,5000,15000,0,12000,3000
08/03/24,Food,Food,Takoyaki,3,10000,30000,0,24000,6000
08/03/24,Food,Food,Steak,4,60000,240000,0,220000,20000
08/03/24,Food,Food,Rendang,1,10000,10000,0,8000,2000
08/03/24,Food,Food,Fried Chicken,10,3000,30000,0,20000,10000
08/03/24,Food,Food,Noodles,8,6000,48000,0,40000,8000
08/03/24,Food,Food,Salmon,4,15000,60000,0,56000,4000
08/03/24,Food,Food,Macaroni,1,5000,5000,0,4000,1000
08/03/24,Food,Food,Fish & Chips,3,30000,90000,0,81000,9000
08/03/24,Food,Food,Burger,2,15000,30000,0,28000,2000
08/03/24,Food,Food,Hotdog,3,10000,30000,0,27000,3000
08/03/24,Food,Food,Pasta,1,18000,18000,0,16000,2000
08/03/24,Food,Snack,Chips,2,5000,10000,0,8000,2000
08/03/24,Food,Snack,Popcorn,1,7000,7000,0,6500,500
08/03/24,Food,Snack,Almonds,1,8000,8000,0,7000,1000
08/03/24,Food,Beverages,Lemon Tea,5,4000,20000,0,15000,5000
08/03/24,Food,Beverages,Ocha,2,4000,8000,0,7000,1000
08/03/24,Food,Beverages,Lychee Tea,3,6000,18000,0,15000,3000
08/03/24,Food,Beverages,Oolong Tea,1,6000,6000,0,5000,1000
08/03/24,Food,Beverages,Soda,3,5000,15000,0,12000,3000
08/04/24,Food,Food,Takoyaki,3,10000,30000,0,24000,6000
08/04/24,Food,Food,Steak,4,60000,240000,0,220000,20000
08/04/24,Food,Food,Rendang,1,10000,10000,0,8000,2000
08/04/24,Food,Food,Fried Chicken,10,3000,30000,0,20000,10000
08/04/24,Food,Food,Noodles,8,6000,48000,0,40000,8000
08/04/24,Food,Food,Salmon,4,15000,60000,0,56000,4000
08/04/24,Food,Food,Macaroni,1,5000,5000,0,4000,1000
08/04/24,Food,Food,Fish & Chips,3,30000,90000,0,81000,9000
08/04/24,Food,Food,Burger,2,15000,30000,0,28000,2000
08/04/24,Food,Food,Hotdog,3,10000,30000,0,27000,3000
08/04/24,Food,Food,Pasta,1,18000,18000,0,16000,2000
08/04/24,Food,Snack,Chips,2,5000,10000,0,8000,2000
08/04/24,Food,Snack,Popcorn,1,7000,7000,0,6500,500
08/04/24,Food,Snack,Almonds,1,8000,8000,0,7000,1000
08/04/24,Food,Beverages,Lemon Tea,5,4000,20000,0,15000,5000
08/04/24,Food,Beverages,Ocha,2,4000,8000,0,7000,1000
08/04/24,Food,Beverages,Lychee Tea,3,6000,18000,0,15000,3000
08/04/24,Food,Beverages,Oolong Tea,1,6000,6000,0,5000,1000
08/04/24,Food,Beverages,Soda,3,5000,15000,0,12000,3000
08/05/24,Food,Food,Takoyaki,3,10000,30000,0,24000,6000
08/05/24,Food,Food,Steak,4,60000,240000,0,220000,20000
08/05/24,Food,Food,Rendang,1,10000,10000,0,8000,2000
08/05/24,Food,Food,Fried Chicken,10,3000,30000,0,20000,10000
08/05/24,Food,Food,Noodles,8,6000,48000,0,40000,8000
08/05/24,Food,Food,Salmon,4,15000,60000,0,56000,4000
08/05/24,Food,Food,Macaroni,1,5000,5000,0,4000,1000
08/05/24,Food,Food,Fish & Chips,3,30000,90000,0,81000,9000
08/05/24,Food,Food,Burger,2,15000,30000,0,28000,2000
08/05/24,Food,Food,Hotdog,3,10000,30000,0,27000,3000
08/05/24,Food,Food,Pasta,1,18000,18000,0,16000,2000
08/05/24,Food,Snack,Chips,2,5000,10000,0,8000,2000
08/05/24,Food,Snack,Popcorn,1,7000,7000,0,6500,500
08/05/24,Food,Snack,Almonds,1,8000,8000,0,7000,1000
08/05/24,Food,Beverages,Lemon Tea,5,4000,20000,0,15000,5000
08/05/24,Food,Beverages,Ocha,2,4000,8000,0,7000,1000
08/05/24,Food,Beverages,Lychee Tea,3,6000,18000,0,15000,3000
08/05/24,Food,Beverages,Oolong Tea,1,6000,6000,0,5000,1000
08/05/24,Food,Beverages,Soda,3,5000,15000,0,12000,3000
08/06/24,Food,Food,Takoyaki,3,10000,30000,0,24000,6000
08/06/24,Food,Food,Steak,4,60000,240000,0,220000,20000
08/06/24,Food,Food,Rendang,1,10000,10000,0,8000,2000
08/06/24,Food,Food,Fried Chicken,10,3000,30000,0,20000,10000
08/06/24,Food,Food,Noodles,8,6000,48000,0,40000,8000
08/06/24,Food,Food,Salmon,4,15000,60000,0,56000,4000
08/06/24,Food,Food,Macaroni,1,5000,5000,0,4000,1000
08/06/24,Food,Food,Fish & Chips,3,30000,90000,0,81000,9000
08/06/24,Food,Food,Burger,2,15000,30000,0,28000,2000
08/06/24,Food,Food,Hotdog,3,10000,30000,0,27000,3000
08/06/24,Food,Food,Pasta,1,18000,18000,0,16000,2000
08/06/24,Food,Snack,Chips,2,5000,10000,0,8000,2000
08/06/24,Food,Snack,Popcorn,1,7000,7000,0,6500,500
08/06/24,Food,Snack,Almonds,1,8000,8000,0,7000,1000
08/06/24,Food,Beverages,Lemon Tea,5,4000,20000,0,15000,5000
08/06/24,Food,Beverages,Ocha,2,4000,8000,0,7000,1000
08/06/24,Food,Beverages,Lychee Tea,3,6000,18000,0,15000,3000
08/06/24,Food,Beverages,Oolong Tea,1,6000,6000,0,5000,1000
08/06/24,Food,Beverages,Soda,3,5000,15000,0,12000,3000
08/07/24,Food,Food,Takoyaki,3,10000,30000,0,24000,6000
08/07/24,Food,Food,Steak,4,60000,240000,0,220000,20000
08/07/24,Food,Food,Rendang,1,10000,10000,0,8000,2000
08/07/24,Food,Food,Fried Chicken,10,3000,30000,0,20000,10000
08/07/24,Food,Food,Noodles,8,6000,48000,0,40000,8000
08/07/24,Food,Food,Salmon,4,15000,60000,0,56000,4000
08/07/24,Food,Food,Macaroni,1,5000,5000,0,4000,1000
08/07/24,Food,Food,Fish & Chips,3,30000,90000,0,81000,9000
08/07/24,Food,Food,Burger,2,15000,30000,0,28000,2000
08/07/24,Food,Food,Hotdog,3,10000,30000,0,27000,3000
08/07/24,Food,Food,Pasta,1,18000,18000,0,16000,2000
08/07/24,Food,Snack,Chips,2,5000,10000,0,8000,2000
08/07/24,Food,Snack,Popcorn,1,7000,7000,0,6500,500
08/07/24,Food,Snack,Almonds,1,8000,8000,0,7000,1000
08/07/24,Food,Beverages,Lemon Tea,5,4000,20000,0,15000,5000
08/07/24,Food,Beverages,Ocha,2,4000,8000,0,7000,1000
08/07/24,Food,Beverages,Lychee Tea,3,6000,18000,0,15000,3000
08/07/24,Food,Beverages,Oolong Tea,1,6000,6000,0,5000,1000
08/07/24,Food,Beverages,Soda,3,5000,15000,0,12000,3000
08/08/24,Food,Food,Takoyaki,3,10000,30000,0,24000,6000
08/08/24,Food,Food,Steak,4,60000,240000,0,220000,20000
08/08/24,Food,Food,Rendang,1,10000,10000,0,8000,2000
08/08/24,Food,Food,Fried Chicken,10,3000,30000,0,20000,10000
08/08/24,Food,Food,Noodles,8,6000,48000,0,40000,8000
08/08/24,Food,Food,Salmon,4,15000,60000,0,56000,4000
08/08/24,Food,Food,Macaroni,1,5000,5000,0,4000,1000
08/08/24,Food,Food,Fish & Chips,3,30000,90000,0,81000,9000
08/08/24,Food,Food,Burger,2,15000,30000,0,28000,2000
08/08/24,Food,Food,Hotdog,3,10000,30000,0,27000,3000
08/08/24,Food,Food,Pasta,1,18000,18000,0,16000,2000
08/08/24,Food,Snack,Chips,2,5000,10000,0,8000,2000
08/08/24,Food,Snack,Popcorn,1,7000,7000,0,6500,500
08/08/24,Food,Snack,Almonds,1,8000,8000,0,7000,1000
08/08/24,Food,Beverages,Lemon Tea,5,4000,20000,0,15000,5000
08/08/24,Food,Beverages,Ocha,2,4000,8000,0,7000,1000
08/08/24,Food,Beverages,Lychee Tea,3,6000,18000,0,15000,3000
08/08/24,Food,Beverages,Oolong Tea,1,6000,6000,0,5000,1000
08/08/24,Food,Beverages,Soda,3,5000,15000,0,12000,3000
08/09/24,Food,Food,Takoyaki,3,10000,30000,0,24000,6000
08/09/24,Food,Food,Steak,4,60000,240000,0,220000,20000
08/09/24,Food,Food,Rendang,1,10000,10000,0,8000,2000
08/09/24,Food,Food,Fried Chicken,10,3000,30000,0,20000,10000
08/09/24,Food,Food,Noodles,8,6000,48000,0,40000,8000
08/09/24,Food,Food,Salmon,4,15000,60000,0,56000,4000
08/09/24,Food,Food,Macaroni,1,5000,5000,0,4000,1000
08/09/24,Food,Food,Fish & Chips,3,30000,90000,0,81000,9000
08/09/24,Food,Food,Burger,2,15000,30000,0,28000,2000
08/09/24,Food,Food,Hotdog,3,10000,30000,0,27000,3000
08/09/24,Food,Food,Pasta,1,18000,18000,0,16000,2000
08/09/24,Food,Snack,Chips,2,5000,10000,0,8000,2000
08/09/24,Food,Snack,Popcorn,1,7000,7000,0,6500,500
08/09/24,Food,Snack,Almonds,1,8000,8000,0,7000,1000
08/09/24,Food,Beverages,Lemon Tea,5,4000,20000,0,15000,5000
08/09/24,Food,Beverages,Ocha,2,4000,8000,0,7000,1000
08/09/24,Food,Beverages,Lychee Tea,3,6000,18000,0,15000,3000
08/09/24,Food,Beverages,Oolong Tea,1,6000,6000,0,5000,1000
08/09/24,Food,Beverages,Soda,3,5000,15000,0,12000,3000
08/10/24,Food,Food,Takoyaki,3,10000,30000,0,24000,6000
08/10/24,Food,Food,Steak,4,60000,240000,0,220000,20000
08/10/24,Food,Food,Rendang,1,10000,10000,0,8000,2000
08/10/24,Food,Food,Fried Chicken,10,3000,30000,0,20000,10000
08/10/24,Food,Food,Noodles,8,6000,48000,0,40000,8000
08/10/24,Food,Food,Salmon,4,15000,60000,0,56000,4000
08/10/24,Food,Food,Macaroni,1,5000,5000,0,4000,1000
08/10/24,Food,Food,Fish & Chips,3,30000,90000,0,81000,9000
08/10/24,Food,Food,Burger,2,15000,30000,0,28000,2000
08/10/24,Food,Food,Hotdog,3,10000,30000,0,27000,3000
08/10/24,Food,Food,Pasta,1,18000,18000,0,16000,2000
08/10/24,Food,Snack,Chips,2,5000,10000,0,8000,2000
08/10/24,Food,Snack,Popcorn,1,7000,7000,0,6500,500
08/10/24,Food,Snack,Almonds,1,8000,8000,0,7000,1000
08/10/24,Food,Beverages,Lemon Tea,5,4000,20000,0,15000,5000
08/10/24,Food,Beverages,Ocha,2,4000,8000,0,7000,1000
08/10/24,Food,Beverages,Lychee Tea,3,6000,18000,0,15000,3000
08/10/24,Food,Beverages,Oolong Tea,1,6000,6000,0,5000,1000
08/10/24,Food,Beverages,Soda,3,5000,15000,0,12000,3000
08/11/24,Food,Food,Takoyaki,3,10000,30000,0,24000,6000
08/11/24,Food,Food,Steak,4,60000,240000,0,220000,20000
08/11/24,Food,Food,Rendang,1,10000,10000,0,8000,2000
08/11/24,Food,Food,Fried Chicken,10,3000,30000,0,20000,10000
08/11/24,Food,Food,Noodles,8,6000,48000,0,40000,8000
08/11/24,Food,Food,Salmon,4,15000,60000,0,56000,4000
08/11/24,Food,Food,Macaroni,1,5000,5000,0,4000,1000
08/11/24,Food,Food,Fish & Chips,3,30000,90000,0,81000,9000
08/11/24,Food,Food,Burger,2,15000,30000,0,28000,2000
08/11/24,Food,Food,Hotdog,3,10000,30000,0,27000,3000
08/11/24,Food,Food,Pasta,1,18000,18000,0,16000,2000
08/11/24,Food,Snack,Chips,2,5000,10000,0,8000,2000
08/11/24,Food,Snack,Popcorn,1,7000,7000,0,6500,500
08/11/24,Food,Snack,Almonds,1,8000,8000,0,7000,1000
08/11/24,Food,Beverages,Lemon Tea,5,4000,20000,0,15000,5000
08/11/24,Food,Beverages,Ocha,2,4000,8000,0,7000,1000
08/11/24,Food,Beverages,Lychee Tea,3,6000,18000,0,15000,3000
08/11/24,Food,Beverages,Oolong Tea,1,6000,6000,0,5000,1000
08/11/24,Food,Beverages,Soda,3,5000,15000,0,12000,3000
08/12/24,Food,Food,Takoyaki,3,10000,30000,0,24000,6000
08/12/24,Food,Food,Steak,4,60000,240000,0,220000,20000
08/12/24,Food,Food,Rendang,1,10000,10000,0,8000,2000
08/12/24,Food,Food,Fried Chicken,10,3000,30000,0,20000,10000
08/12/24,Food,Food,Noodles,8,6000,48000,0,40000,8000
08/12/24,Food,Food,Salmon,4,15000,60000,0,56000,4000
08/12/24,Food,Food,Macaroni,1,5000,5000,0,4000,1000
08/12/24,Food,Food,Fish & Chips,3,30000,90000,0,81000,9000
08/12/24,Food,Food,Burger,2,15000,30000,0,28000,2000
08/12/24,Food,Food,Hotdog,3,10000,30000,0,27000,3000
08/12/24,Food,Food,Pasta,1,18000,18000,0,16000,2000
08/12/24,Food,Snack,Chips,2,5000,10000,0,8000,2000
08/12/24,Food,Snack,Popcorn,1,7000,7000,0,6500,500
08/12/24,Food,Snack,Almonds,1,8000,8000,0,7000,1000
08/12/24,Food,Beverages,Lemon Tea,5,4000,20000,0,15000,5000
08/12/24,Food,Beverages,Ocha,2,4000,8000,0,7000,1000
08/12/24,Food,Beverages,Lychee Tea,3,6000,18000,0,15000,3000
08/12/24,Food,Beverages,Oolong Tea,1,6000,6000,0,5000,1000
08/12/24,Food,Beverages,Soda,3,5000,15000,0,12000,3000
08/13/24,Food,Food,Takoyaki,3,10000,30000,0,24000,6000
08/13/24,Food,Food,Steak,4,60000,240000,0,220000,20000
08/13/24,Food,Food,Rendang,1,10000,10000,0,8000,2000
08/13/24,Food,Food,Fried Chicken,10,3000,30000,0,20000,10000
08/13/24,Food,Food,Noodles,8,6000,48000,0,40000,8000
08/13/24,Food,Food,Salmon,4,15000,60000,0,56000,4000
08/13/24,Food,Food,Macaroni,1,5000,5000,0,4000,1000
08/13/24,Food,Food,Fish & Chips,3,30000,90000,0,81000,9000
08/13/24,Food,Food,Burger,2,15000,30000,0,28000,2000
08/13/24,Food,Food,Hotdog,3,10000,30000,0,27000,3000
08/13/24,Food,Food,Pasta,1,18000,18000,0,16000,2000
08/13/24,Food,Snack,Chips,2,5000,10000,0,8000,2000
08/13/24,Food,Snack,Popcorn,1,7000,7000,0,6500,500
08/13/24,Food,Snack,Almonds,1,8000,8000,0,7000,1000
08/13/24,Food,Beverages,Lemon Tea,5,4000,20000,0,15000,5000
08/13/24,Food,Beverages,Ocha,2,4000,8000,0,7000,1000
08/13/24,Food,Beverages,Lychee Tea,3,6000,18000,0,15000,3000
08/13/24,Food,Beverages,Oolong Tea,1,6000,6000,0,5000,1000
08/13/24,Food,Beverages,Soda,3,5000,15000,0,12000,3000
08/14/24,Food,Food,Takoyaki,3,10000,30000,0,24000,6000
08/14/24,Food,Food,Steak,4,60000,240000,0,220000,20000
08/14/24,Food,Food,Rendang,1,10000,10000,0,8000,2000
08/14/24,Food,Food,Fried Chicken,10,3000,30000,0,20000,10000
08/14/24,Food,Food,Noodles,8,6000,48000,0,40000,8000
08/14/24,Food,Food,Salmon,4,15000,60000,0,56000,4000
08/14/24,Food,Food,Macaroni,1,5000,5000,0,4000,1000
08/14/24,Food,Food,Fish & Chips,3,30000,90000,0,81000,9000
08/14/24,Food,Food,Burger,2,15000,30000,0,28000,2000
08/14/24,Food,Food,Hotdog,3,10000,30000,0,27000,3000
08/14/24,Food,Food,Pasta,1,18000,18000,0,16000,2000
08/14/24,Food,Snack,Chips,2,5000,10000,0,8000,2000
08/14/24,Food,Snack,Popcorn,1,7000,7000,0,6500,500
08/14/24,Food,Snack,Almonds,1,8000,8000,0,7000,1000
08/14/24,Food,Beverages,Lemon Tea,5,4000,20000,0,15000,5000
08/14/24,Food,Beverages,Ocha,2,4000,8000,0,7000,1000
08/14/24,Food,Beverages,Lychee Tea,3,6000,18000,0,15000,3000
08/14/24,Food,Beverages,Oolong Tea,1,6000,6000,0,5000,1000
08/14/24,Food,Beverages,Soda,3,5000,15000,0,12000,3000
08/15/24,Food,Food,Takoyaki,3,10000,30000,0,24000,6000
08/15/24,Food,Food,Steak,4,60000,240000,0,220000,20000
08/15/24,Food,Food,Rendang,1,10000,10000,0,8000,2000
08/15/24,Food,Food,Fried Chicken,10,3000,30000,0,20000,10000
08/15/24,Food,Food,Noodles,8,6000,48000,0,40000,8000
08/15/24,Food,Food,Salmon,4,15000,60000,0,56000,4000
08/15/24,Food,Food,Macaroni,1,5000,5000,0,4000,1000
08/15/24,Food,Food,Fish & Chips,3,30000,90000,0,81000,9000
08/15/24,Food,Food,Burger,2,15000,30000,0,28000,2000
08/15/24,Food,Food,Hotdog,3,10000,30000,0,27000,3000
08/15/24,Food,Food,Pasta,1,18000,18000,0,16000,2000
08/15/24,Food,Snack,Chips,2,5000,10000,0,8000,2000
08/15/24,Food,Snack,Popcorn,1,7000,7000,0,6500,500
08/15/24,Food,Snack,Almonds,1,8000,8000,0,7000,1000
08/15/24,Food,Beverages,Lemon Tea,5,4000,20000,0,15000,5000
08/15/24,Food,Beverages,Ocha,2,4000,8000,0,7000,1000
08/15/24,Food,Beverages,Lychee Tea,3,6000,18000,0,15000,3000
08/15/24,Food,Beverages,Oolong Tea,1,6000,6000,0,5000,1000
08/15/24,Food,Beverages,Soda,3,5000,15000,0,12000,3000
08/16/24,Food,Food,Takoyaki,3,10000,30000,0,24000,6000
08/16/24,Food,Food,Steak,4,60000,240000,0,220000,20000
08/16/24,Food,Food,Rendang,1,10000,10000,0,8000,2000
08/16/24,Food,Food,Fried Chicken,10,3000,30000,0,20000,10000
08/16/24,Food,Food,Noodles,8,6000,48000,0,40000,8000
08/16/24,Food,Food,Salmon,4,15000,60000,0,56000,4000
08/16/24,Food,Food,Macaroni,1,5000,5000,0,4000,1000
08/16/24,Food,Food,Fish & Chips,3,30000,90000,0,81000,9000
08/16/24,Food,Food,Burger,2,15000,30000,0,28000,2000
08/16/24,Food,Food,Hotdog,3,10000,30000,0,27000,3000
08/16/24,Food,Food,Pasta,1,18000,18000,0,16000,2000
08/16/24,Food,Snack,Chips,2,5000,10000,0,8000,2000
08/16/24,Food,Snack,Popcorn,1,7000,7000,0,6500,500
08/16/24,Food,Snack,Almonds,1,8000,8000,0,7000,1000
08/16/24,Food,Beverages,Lemon Tea,5,4000,20000,0,15000,5000
08/16/24,Food,Beverages,Ocha,2,4000,8000,0,7000,1000
08/16/24,Food,Beverages,Lychee Tea,3,6000,18000,0,15000,3000
08/16/24,Food,Beverages,Oolong Tea,1,6000,6000,0,5000,1000
08/16/24,Food,Beverages,Soda,3,5000,15000,0,12000,3000
08/17/24,Food,Food,Takoyaki,3,10000,30000,0,24000,6000
08/17/24,Food,Food,Steak,4,60000,240000,0,220000,20000
08/17/24,Food,Food,Rendang,1,10000,10000,0,8000,2000
08/17/24,Food,Food,Fried Chicken,10,3000,30000,0,20000,10000
08/17/24,Food,Food,Noodles,8,6000,48000,0,40000,8000
08/17/24,Food,Food,Salmon,4,15000,60000,0,56000,4000
08/17/24,Food,Food,Macaroni,1,5000,5000,0,4000,1000
08/17/24,Food,Food,Fish & Chips,3,30000,90000,0,81000,9000
08/17/24,Food,Food,Burger,2,15000,30000,0,28000,2000
08/17/24,Food,Food,Hotdog,3,10000,30000,0,27000,3000
08/17/24,Food,Food,Pasta,1,18000,18000,0,16000,2000
08/17/24,Food,Snack,Chips,2,5000,10000,0,8000,2000
08/17/24,Food,Snack,Popcorn,1,7000,7000,0,6500,500
08/17/24,Food,Snack,Almonds,1,8000,8000,0,7000,1000
08/17/24,Food,Beverages,Lemon Tea,5,4000,20000,0,15000,5000
08/17/24,Food,Beverages,Ocha,2,4000,8000,0,7000,1000
08/17/24,Food,Beverages,Lychee Tea,3,6000,18000,0,15000,3000
08/17/24,Food,Beverages,Oolong Tea,1,6000,6000,0,5000,1000
08/17/24,Food,Beverages,Soda,3,5000,15000,0,12000,3000
08/18/24,Food,Food,Takoyaki,3,10000,30000,0,24000,6000
08/18/24,Food,Food,Steak,4,60000,240000,0,220000,20000
08/18/24,Food,Food,Rendang,1,10000,10000,0,8000,2000
08/18/24,Food,Food,Fried Chicken,10,3000,30000,0,20000,10000
08/18/24,Food,Food,Noodles,8,6000,48000,0,40000,8000
08/18/24,Food,Food,Salmon,4,15000,60000,0,56000,4000
08/18/24,Food,Food,Macaroni,1,5000,5000,0,4000,1000
08/18/24,Food,Food,Fish & Chips,3,30000,90000,0,81000,9000
08/18/24,Food,Food,Burger,2,15000,30000,0,28000,2000
08/18/24,Food,Food,Hotdog,3,10000,30000,0,27000,3000
08/18/24,Food,Food,Pasta,1,18000,18000,0,16000,2000
08/18/24,Food,Snack,Chips,2,5000,10000,0,8000,2000
08/18/24,Food,Snack,Popcorn,1,7000,7000,0,6500,500
08/18/24,Food,Snack,Almonds,1,8000,8000,0,7000,1000
08/18/24,Food,Beverages,Lemon Tea,5,4000,20000,0,15000,5000
08/18/24,Food,Beverages,Ocha,2,4000,8000,0,7000,1000
08/18/24,Food,Beverages,Lychee Tea,3,6000,18000,0,15000,3000
08/18/24,Food,Beverages,Oolong Tea,1,6000,6000,0,5000,1000
08/18/24,Food,Beverages,Soda,3,5000,15000,0,12000,3000
08/19/24,Food,Food,Takoyaki,3,10000,30000,0,24000,6000
08/19/24,Food,Food,Steak,4,60000,240000,0,220000,20000
08/19/24,Food,Food,Rendang,1,10000,10000,0,8000,2000
08/19/24,Food,Food,Fried Chicken,10,3000,30000,0,20000,10000
08/19/24,Food,Food,Noodles,8,6000,48000,0,40000,8000
08/19/24,Food,Food,Salmon,4,15000,60000,0,56000,4000
08/19/24,Food,Food,Macaroni,1,5000,5000,0,4000,1000
08/19/24,Food,Food,Fish & Chips,3,30000,90000,0,81000,9000
08/19/24,Food,Food,Burger,2,15000,30000,0,28000,2000
08/19/24,Food,Food,Hotdog,3,10000,30000,0,27000,3000
08/19/24,Food,Food,Pasta,1,18000,18000,0,16000,2000
08/19/24,Food,Snack,Chips,2,5000,10000,0,8000,2000
08/19/24,Food,Snack,Popcorn,1,7000,7000,0,6500,500
08/19/24,Food,Snack,Almonds,1,8000,8000,0,7000,1000
08/19/24,Food,Beverages,Lemon Tea,5,4000,20000,0,15000,5000
08/19/24,Food,Beverages,Ocha,2,4000,8000,0,7000,1000
08/19/24,Food,Beverages,Lychee Tea,3,6000,18000,0,15000,3000
08/19/24,Food,Beverages,Oolong Tea,1,6000,6000,0,5000,1000
08/19/24,Food,Beverages,Soda,3,5000,15000,0,12000,3000
08/20/24,Food,Food,Takoyaki,3,10000,30000,0,24000,6000
08/20/24,Food,Food,Steak,4,60000,240000,0,220000,20000
08/20/24,Food,Food,Rendang,1,10000,10000,0,8000,2000
08/20/24,Food,Food,Fried Chicken,10,3000,30000,0,20000,10000
08/20/24,Food,Food,Noodles,8,6000,48000,0,40000,8000
08/20/24,Food,Food,Salmon,4,15000,60000,0,56000,4000
08/20/24,Food,Food,Macaroni,1,5000,5000,0,4000,1000
08/20/24,Food,Food,Fish & Chips,3,30000,90000,0,81000,9000
08/20/24,Food,Food,Burger,2,15000,30000,0,28000,2000
08/20/24,Food,Food,Hotdog,3,10000,30000,0,27000,3000
08/20/24,Food,Food,Pasta,1,18000,18000,0,16000,2000
08/20/24,Food,Snack,Chips,2,5000,10000,0,8000,2000
08/20/24,Food,Snack,Popcorn,1,7000,7000,0,6500,500
08/20/24,Food,Snack,Almonds,1,8000,8000,0,7000,1000
08/20/24,Food,Beverages,Lemon Tea,5,4000,20000,0,15000,5000
08/20/24,Food,Beverages,Ocha,2,4000,8000,0,7000,1000
08/20/24,Food,Beverages,Lychee Tea,3,6000,18000,0,15000,3000
08/20/24,Food,Beverages,Oolong Tea,1,6000,6000,0,5000,1000
08/20/24,Food,Beverages,Soda,3,5000,15000,0,12000,3000
08/21/24,Food,Food,Takoyaki,3,10000,30000,0,24000,6000
08/21/24,Food,Food,Steak,4,60000,240000,0,220000,20000
08/21/24,Food,Food,Rendang,1,10000,10000,0,8000,2000
08/21/24,Food,Food,Fried Chicken,10,3000,30000,0,20000,10000
08/21/24,Food,Food,Noodles,8,6000,48000,0,40000,8000
08/21/24,Food,Food,Salmon,4,15000,60000,0,56000,4000
08/21/24,Food,Food,Macaroni,1,5000,5000,0,4000,1000
08/21/24,Food,Food,Fish & Chips,3,30000,90000,0,81000,9000
08/21/24,Food,Food,Burger,2,15000,30000,0,28000,2000
08/21/24,Food,Food,Hotdog,3,10000,30000,0,27000,3000
08/21/24,Food,Food,Pasta,1,18000,18000,0,16000,2000
08/21/24,Food,Snack,Chips,2,5000,10000,0,8000,2000
08/21/24,Food,Snack,Popcorn,1,7000,7000,0,6500,500
08/21/24,Food,Snack,Almonds,1,8000,8000,0,7000,1000
08/21/24,Food,Beverages,Lemon Tea,5,4000,20000,0,15000,5000
08/21/24,Food,Beverages,Ocha,2,4000,8000,0,7000,1000
08/21/24,Food,Beverages,Lychee Tea,3,6000,18000,0,15000,3000
08/21/24,Food,Beverages,Oolong Tea,1,6000,6000,0,5000,1000
08/21/24,Food,Beverages,Soda,3,5000,15000,0,12000,3000
08/22/24,Food,Food,Takoyaki,3,10000,30000,0,24000,6000
08/22/24,Food,Food,Steak,4,60000,240000,0,220000,20000
08/22/24,Food,Food,Rendang,1,10000,10000,0,8000,2000
08/22/24,Food,Food,Fried Chicken,10,3000,30000,0,20000,10000
08/22/24,Food,Food,Noodles,8,6000,48000,0,40000,8000
08/22/24,Food,Food,Salmon,4,15000,60000,0,56000,4000
08/22/24,Food,Food,Macaroni,1,5000,5000,0,4000,1000
08/22/24,Food,Food,Fish & Chips,3,30000,90000,0,81000,9000
08/22/24,Food,Food,Burger,2,15000,30000,0,28000,2000
08/22/24,Food,Food,Hotdog,3,10000,30000,0,27000,3000
08/22/24,Food,Food,Pasta,1,18000,18000,0,16000,2000
08/22/24,Food,Snack,Chips,2,5000,10000,0,8000,2000
08/22/24,Food,Snack,Popcorn,1,7000,7000,0,6500,500
08/22/24,Food,Snack,Almonds,1,8000,8000,0,7000,1000
08/22/24,Food,Beverages,Lemon Tea,5,4000,20000,0,15000,5000
08/22/24,Food,Beverages,Ocha,2,4000,8000,0,7000,1000
08/22/24,Food,Beverages,Lychee Tea,3,6000,18000,0,15000,3000
08/22/24,Food,Beverages,Oolong Tea,1,6000,6000,0,5000,1000
08/22/24,Food,Beverages,Soda,3,5000,15000,0,12000,3000
08/23/24,Food,Food,Takoyaki,3,10000,30000,0,24000,6000
08/23/24,Food,Food,Steak,4,60000,240000,0,220000,20000
08/23/24,Food,Food,Rendang,1,10000,10000,0,8000,2000
08/23/24,Food,Food,Fried Chicken,10,3000,30000,0,20000,10000
08/23/24,Food,Food,Noodles,8,6000,48000,0,40000,8000
08/23/24,Food,Food,Salmon,4,15000,60000,0,56000,4000
08/23/24,Food,Food,Macaroni,1,5000,5000,0,4000,1000
08/23/24,Food,Food,Fish & Chips,3,30000,90000,0,81000,9000
08/23/24,Food,Food,Burger,2,15000,30000,0,28000,2000
08/23/24,Food,Food,Hotdog,3,10000,30000,0,27000,3000
08/23/24,Food,Food,Pasta,1,18000,18000,0,16000,2000
08/23/24,Food,Snack,Chips,2,5000,10000,0,8000,2000
08/23/24,Food,Snack,Popcorn,1,7000,7000,0,6500,500
08/23/24,Food,Snack,Almonds,1,8000,8000,0,7000,1000
08/23/24,Food,Beverages,Lemon Tea,5,4000,20000,0,15000,5000
08/23/24,Food,Beverages,Ocha,2,4000,8000,0,7000,1000
08/23/24,Food,Beverages,Lychee Tea,3,6000,18000,0,15000,3000
08/23/24,Food,Beverages,Oolong Tea,1,6000,6000,0,5000,1000
08/23/24,Food,Beverages,Soda,3,5000,15000,0,12000,3000
08/24/24,Food,Food,Takoyaki,3,10000,30000,0,24000,6000
08/24/24,Food,Food,Steak,4,60000,240000,0,220000,20000
08/24/24,Food,Food,Rendang,1,10000,10000,0,8000,2000
08/24/24,Food,Food,Fried Chicken,10,3000,30000,0,20000,10000
08/24/24,Food,Food,Noodles,8,6000,48000,0,40000,8000
08/24/24,Food,Food,Salmon,4,15000,60000,0,56000,4000
08/24/24,Food,Food,Macaroni,1,5000,5000,0,4000,1000
08/24/24,Food,Food,Fish & Chips,3,30000,90000,0,81000,9000
08/24/24,Food,Food,Burger,2,15000,30000,0,28000,2000
08/24/24,Food,Food,Hotdog,3,10000,30000,0,27000,3000
08/24/24,Food,Food,Pasta,1,18000,18000,0,16000,2000
08/24/24,Food,Snack,Chips,2,5000,10000,0,8000,2000
08/24/24,Food,Snack,Popcorn,1,7000,7000,0,6500,500
08/24/24,Food,Snack,Almonds,1,8000,8000,0,7000,1000
08/24/24,Food,Beverages,Lemon Tea,5,4000,20000,0,15000,5000
08/24/24,Food,Beverages,Ocha,2,4000,8000,0,7000,1000
08/24/24,Food,Beverages,Lychee Tea,3,6000,18000,0,15000,3000
08/24/24,Food,Beverages,Oolong Tea,1,6000,6000,0,5000,1000
08/24/24,Food,Beverages,Soda,3,5000,15000,0,12000,3000
08/25/24,Food,Food,Takoyaki,3,10000,30000,0,24000,6000
08/25/24,Food,Food,Steak,4,60000,240000,0,220000,20000
08/25/24,Food,Food,Rendang,1,10000,10000,0,8000,2000
08/25/24,Food,Food,Fried Chicken,10,3000,30000,0,20000,10000
08/25/24,Food,Food,Noodles,8,6000,48000,0,40000,8000
08/25/24,Food,Food,Salmon,4,15000,60000,0,56000,4000
08/25/24,Food,Food,Macaroni,1,5000,5000,0,4000,1000
08/25/24,Food,Food,Fish & Chips,3,30000,90000,0,81000,9000
08/25/24,Food,Food,Burger,2,15000,30000,0,28000,2000
08/25/24,Food,Food,Hotdog,3,10000,30000,0,27000,3000
08/25/24,Food,Food,Pasta,1,18000,18000,0,16000,2000
08/25/24,Food,Snack,Chips,2,5000,10000,0,8000,2000
08/25/24,Food,Snack,Popcorn,1,7000,7000,0,6500,500
08/25/24,Food,Snack,Almonds,1,8000,8000,0,7000,1000
08/25/24,Food,Beverages,Lemon Tea,5,4000,20000,0,15000,5000
08/25/24,Food,Beverages,Ocha,2,4000,8000,0,7000,1000
08/25/24,Food,Beverages,Lychee Tea,3,6000,18000,0,15000,3000
08/25/24,Food,Beverages,Oolong Tea,1,6000,6000,0,5000,1000
08/25/24,Food,Beverages,Soda,3,5000,15000,0,12000,3000
08/26/24,Food,Food,Takoyaki,3,10000,30000,0,24000,6000
08/26/24,Food,Food,Steak,4,60000,240000,0,220000,20000
08/26/24,Food,Food,Rendang,1,10000,10000,0,8000,2000
08/26/24,Food,Food,Fried Chicken,10,3000,30000,0,20000,10000
08/26/24,Food,Food,Noodles,8,6000,48000,0,40000,8000
08/26/24,Food,Food,Salmon,4,15000,60000,0,56000,4000
08/26/24,Food,Food,Macaroni,1,5000,5000,0,4000,1000
08/26/24,Food,Food,Fish & Chips,3,30000,90000,0,81000,9000
08/26/24,Food,Food,Burger,2,15000,30000,0,28000,2000
08/26/24,Food,Food,Hotdog,3,10000,30000,0,27000,3000
08/26/24,Food,Food,Pasta,1,18000,18000,0,16000,2000
08/26/24,Food,Snack,Chips,2,5000,10000,0,8000,2000
08/26/24,Food,Snack,Popcorn,1,7000,7000,0,6500,500
08/26/24,Food,Snack,Almonds,1,8000,8000,0,7000,1000
08/26/24,Food,Beverages,Lemon Tea,5,4000,20000,0,15000,5000
08/26/24,Food,Beverages,Ocha,2,4000,8000,0,7000,1000
08/26/24,Food,Beverages,Lychee Tea,3,6000,18000,0,15000,3000
08/26/24,Food,Beverages,Oolong Tea,1,6000,6000,0,5000,1000
08/26/24,Food,Beverages,Soda,3,5000,15000,0,12000,3000
08/27/24,Food,Food,Takoyaki,3,10000,30000,0,24000,6000
08/27/24,Food,Food,Steak,4,60000,240000,0,220000,20000
08/27/24,Food,Food,Rendang,1,10000,10000,0,8000,2000
08/27/24,Food,Food,Fried Chicken,10,3000,30000,0,20000,10000
08/27/24,Food,Food,Noodles,8,6000,48000,0,40000,8000
08/27/24,Food,Food,Salmon,4,15000,60000,0,56000,4000
08/27/24,Food,Food,Macaroni,1,5000,5000,0,4000,1000
08/27/24,Food,Food,Fish & Chips,3,30000,90000,0,81000,9000
08/27/24,Food,Food,Burger,2,15000,30000,0,28000,2000
08/27/24,Food,Food,Hotdog,3,10000,30000,0,27000,3000
08/27/24,Food,Food,Pasta,1,18000,18000,0,16000,2000
08/27/24,Food,Snack,Chips,2,5000,10000,0,8000,2000
08/27/24,Food,Snack,Popcorn,1,7000,7000,0,6500,500
08/27/24,Food,Snack,Almonds,1,8000,8000,0,7000,1000
08/27/24,Food,Beverages,Lemon Tea,5,4000,20000,0,15000,5000
08/27/24,Food,Beverages,Ocha,2,4000,8000,0,7000,1000
08/27/24,Food,Beverages,Lychee Tea,3,6000,18000,0,15000,3000
08/27/24,Food,Beverages,Oolong Tea,1,6000,6000,0,5000,1000
08/27/24,Food,Beverages,Soda,3,5000,15000,0,12000,3000
08/28/24,Food,Food,Takoyaki,3,10000,30000,0,24000,6000
08/28/24,Food,Food,Steak,4,60000,240000,0,220000,20000
08/28/24,Food,Food,Rendang,1,10000,10000,0,8000,2000
08/28/24,Food,Food,Fried Chicken,10,3000,30000,0,20000,10000
08/28/24,Food,Food,Noodles,8,6000,48000,0,40000,8000
08/28/24,Food,Food,Salmon,4,15000,60000,0,56000,4000
08/28/24,Food,Food,Macaroni,1,5000,5000,0,4000,1000
08/28/24,Food,Food,Fish & Chips,3,30000,90000,0,81000,9000
08/28/24,Food,Food,Burger,2,15000,30000,0,28000,2000
08/28/24,Food,Food,Hotdog,3,10000,30000,0,27000,3000
08/28/24,Food,Food,Pasta,1,18000,18000,0,16000,2000
08/28/24,Food,Snack,Chips,2,5000,10000,0,8000,2000
08/28/24,Food,Snack,Popcorn,1,7000,7000,0,6500,500
08/28/24,Food,Snack,Almonds,1,8000,8000,0,7000,1000
08/28/24,Food,Beverages,Lemon Tea,5,4000,20000,0,15000,5000
08/28/24,Food,Beverages,Ocha,2,4000,8000,0,7000,1000
08/28/24,Food,Beverages,Lychee Tea,3,6000,18000,0,15000,3000
08/28/24,Food,Beverages,Oolong Tea,1,6000,6000,0,5000,1000
08/28/24,Food,Beverages,Soda,3,5000,15000,0,12000,3000
08/29/24,Food,Food,Takoyaki,3,10000,30000,0,24000,6000
08/29/24,Food,Food,Steak,4,60000,240000,0,220000,20000
08/29/24,Food,Food,Rendang,1,10000,10000,0,8000,2000
08/29/24,Food,Food,Fried Chicken,10,3000,30000,0,20000,10000
08/29/24,Food,Food,Noodles,8,6000,48000,0,40000,8000
08/29/24,Food,Food,Salmon,4,15000,60000,0,56000,4000
08/29/24,Food,Food,Macaroni,1,5000,5000,0,4000,1000
08/29/24,Food,Food,Fish & Chips,3,30000,90000,0,81000,9000
08/29/24,Food,Food,Burger,2,15000,30000,0,28000,2000
08/29/24,Food,Food,Hotdog,3,10000,30000,0,27000,3000
08/29/24,Food,Food,Pasta,1,18000,18000,0,16000,2000
08/29/24,Food,Snack,Chips,2,5000,10000,0,8000,2000
08/29/24,Food,Snack,Popcorn,1,7000,7000,0,6500,500
08/29/24,Food,Snack,Almonds,1,8000,8000,0,7000,1000
08/29/24,Food,Beverages,Lemon Tea,5,4000,20000,0,15000,5000
08/29/24,Food,Beverages,Ocha,2,4000,8000,0,7000,1000
08/29/24,Food,Beverages,Lychee Tea,3,6000,18000,0,15000,3000
08/29/24,Food,Beverages,Oolong Tea,1,6000,6000,0,5000,1000
08/29/24,Food,Beverages,Soda,3,5000,15000,0,12000,3000
08/30/24,Food,Food,Takoyaki,3,10000,30000,0,24000,6000
08/30/24,Food,Food,Steak,4,60000,240000,0,220000,20000
08/30/24,Food,Food,Rendang,1,10000,10000,0,8000,2000
08/30/24,Food,Food,Fried Chicken,10,3000,30000,0,20000,10000
08/30/24,Food,Food,Noodles,8,6000,48000,0,40000,8000
08/30/24,Food,Food,Salmon,4,15000,60000,0,56000,4000
08/30/24,Food,Food,Macaroni,1,5000,5000,0,4000,1000
08/30/24,Food,Food,Fish & Chips,3,30000,90000,0,81000,9000
08/30/24,Food,Food,Burger,2,15000,30000,0,28000,2000
08/30/24,Food,Food,Hotdog,3,10000,30000,0,27000,3000
08/30/24,Food,Food,Pasta,1,18000,18000,0,16000,2000
08/30/24,Food,Snack,Chips,2,5000,10000,0,8000,2000
08/30/24,Food,Snack,Popcorn,1,7000,7000,0,6500,500
08/30/24,Food,Snack,Almonds,1,8000,8000,0,7000,1000
08/30/24,Food,Beverages,Lemon Tea,5,4000,20000,0,15000,5000
08/30/24,Food,Beverages,Ocha,2,4000,8000,0,7000,1000
08/30/24,Food,Beverages,Lychee Tea,3,6000,18000,0,15000,3000
08/30/24,Food,Beverages,Oolong Tea,1,6000,6000,0,5000,1000
08/30/24,Food,Beverages,Soda,3,5000,15000,0,12000,3000
08/31/24,Food,Food,Takoyaki,3,10000,30000,0,24000,6000
08/31/24,Food,Food,Steak,4,60000,240000,0,220000,20000
08/31/24,Food,Food,Rendang,1,10000,10000,0,8000,2000
08/31/24,Food,Food,Fried Chicken,10,3000,30000,0,20000,10000
08/31/24,Food,Food,Noodles,8,6000,48000,0,40000,8000
08/31/24,Food,Food,Salmon,4,15000,60000,0,56000,4000
08/31/24,Food,Food,Macaroni,1,5000,5000,0,4000,1000
08/31/24,Food,Food,Fish & Chips,3,30000,90000,0,81000,9000
08/31/24,Food,Food,Burger,2,15000,30000,0,28000,2000
08/31/24,Food,Food,Hotdog,3,10000,30000,0,27000,3000
08/31/24,Food,Food,Pasta,1,18000,18000,0,16000,2000
08/31/24,Food,Snack,Chips,2,5000,10000,0,8000,2000
08/31/24,Food,Snack,Popcorn,1,7000,7000,0,6500,500
08/31/24,Food,Snack,Almonds,1,8000,8000,0,7000,1000
08/31/24,Food,Beverages,Lemon Tea,5,4000,20000,0,15000,5000
08/31/24,Food,Beverages,Ocha,2,4000,8000,0,7000,1000
08/31/24,Food,Beverages,Lychee Tea,3,6000,18000,0,15000,3000
08/31/24,Food,Beverages,Oolong Tea,1,6000,6000,0,5000,1000
08/31/24,Food,Beverages,Soda,3,5000,15000,0,12000,3000
09/01/24,Food,Food,Takoyaki,3,10000,30000,0,24000,6000
09/01/24,Food,Food,Steak,4,60000,240000,0,220000,20000
09/01/24,Food,Food,Rendang,1,10000,10000,0,8000,2000
09/01/24,Food,Food,Fried Chicken,10,3000,30000,0,20000,10000
09/01/24,Food,Food,Noodles,8,6000,48000,0,40000,8000
09/01/24,Food,Food,Salmon,4,15000,60000,0,56000,4000
09/01/24,Food,Food,Macaroni,1,5000,5000,0,4000,1000
09/01/24,Food,Food,Fish & Chips,3,30000,90000,0,81000,9000
09/01/24,Food,Food,Burger,2,15000,30000,0,28000,2000
09/01/24,Food,Food,Hotdog,3,10000,30000,0,27000,3000
09/01/24,Food,Food,Pasta,1,18000,18000,0,16000,2000
09/01/24,Food,Snack,Chips,2,5000,10000,0,8000,2000
09/01/24,Food,Snack,Popcorn,1,7000,7000,0,6500,500
09/01/24,Food,Snack,Almonds,1,8000,8000,0,7000,1000
09/01/24,Food,Beverages,Lemon Tea,5,4000,20000,0,15000,5000
09/01/24,Food,Beverages,Ocha,2,4000,8000,0,7000,1000
09/01/24,Food,Beverages,Lychee Tea,3,6000,18000,0,15000,3000
09/01/24,Food,Beverages,Oolong Tea,1,6000,6000,0,5000,1000
09/01/24,Food,Beverages,Soda,3,5000,15000,0,12000,3000
09/02/24,Food,Food,Takoyaki,3,10000,30000,0,24000,6000
09/02/24,Food,Food,Steak,4,60000,240000,0,220000,20000
09/02/24,Food,Food,Rendang,1,10000,10000,0,8000,2000
09/02/24,Food,Food,Fried Chicken,10,3000,30000,0,20000,10000
09/02/24,Food,Food,Noodles,8,6000,48000,0,40000,8000
09/02/24,Food,Food,Salmon,4,15000,60000,0,56000,4000
09/02/24,Food,Food,Macaroni,1,5000,5000,0,4000,1000
09/02/24,Food,Food,Fish & Chips,3,30000,90000,0,81000,9000
09/02/24,Food,Food,Burger,2,15000,30000,0,28000,2000
09/02/24,Food,Food,Hotdog,3,10000,30000,0,27000,3000
09/02/24,Food,Food,Pasta,1,18000,18000,0,16000,2000
09/02/24,Food,Snack,Chips,2,5000,10000,0,8000,2000
09/02/24,Food,Snack,Popcorn,1,7000,7000,0,6500,500
09/02/24,Food,Snack,Almonds,1,8000,8000,0,7000,1000
09/02/24,Food,Beverages,Lemon Tea,5,4000,20000,0,15000,5000
09/02/24,Food,Beverages,Ocha,2,4000,8000,0,7000,1000
09/02/24,Food,Beverages,Lychee Tea,3,6000,18000,0,15000,3000
09/02/24,Food,Beverages,Oolong Tea,1,6000,6000,0,5000,1000
09/02/24,Food,Beverages,Soda,3,5000,15000,0,12000,3000
09/03/24,Food,Food,Takoyaki,3,10000,30000,0,24000,6000
09/03/24,Food,Food,Steak,4,60000,240000,0,220000,20000
09/03/24,Food,Food,Rendang,1,10000,10000,0,8000,2000
09/03/24,Food,Food,Fried Chicken,10,3000,30000,0,20000,10000
09/03/24,Food,Food,Noodles,8,6000,48000,0,40000,8000
09/03/24,Food,Food,Salmon,4,15000,60000,0,56000,4000
09/03/24,Food,Food,Macaroni,1,5000,5000,0,4000,1000
09/03/24,Food,Food,Fish & Chips,3,30000,90000,0,81000,9000
09/03/24,Food,Food,Burger,2,15000,30000,0,28000,2000
09/03/24,Food,Food,Hotdog,3,10000,30000,0,27000,3000
09/03/24,Food,Food,Pasta,1,18000,18000,0,16000,2000
09/03/24,Food,Snack,Chips,2,5000,10000,0,8000,2000
09/03/24,Food,Snack,Popcorn,1,7000,7000,0,6500,500
09/03/24,Food,Snack,Almonds,1,8000,8000,0,7000,1000
09/03/24,Food,Beverages,Lemon Tea,5,4000,20000,0,15000,5000
09/03/24,Food,Beverages,Ocha,2,4000,8000,0,7000,1000
09/03/24,Food,Beverages,Lychee Tea,3,6000,18000,0,15000,3000
09/03/24,Food,Beverages,Oolong Tea,1,6000,6000,0,5000,1000
09/03/24,Food,Beverages,Soda,3,5000,15000,0,12000,3000
09/04/24,Food,Food,Takoyaki,3,10000,30000,0,24000,6000
09/04/24,Food,Food,Steak,4,60000,240000,0,220000,20000
09/04/24,Food,Food,Rendang,1,10000,10000,0,8000,2000
09/04/24,Food,Food,Fried Chicken,10,3000,30000,0,20000,10000
09/04/24,Food,Food,Noodles,8,6000,48000,0,40000,8000
09/04/24,Food,Food,Salmon,4,15000,60000,0,56000,4000
09/04/24,Food,Food,Macaroni,1,5000,5000,0,4000,1000
09/04/24,Food,Food,Fish & Chips,3,30000,90000,0,81000,9000
09/04/24,Food,Food,Burger,2,15000,30000,0,28000,2000
09/04/24,Food,Food,Hotdog,3,10000,30000,0,27000,3000
09/04/24,Food,Food,Pasta,1,18000,18000,0,16000,2000
09/04/24,Food,Snack,Chips,2,5000,10000,0,8000,2000
09/04/24,Food,Snack,Popcorn,1,7000,7000,0,6500,500
09/04/24,Food,Snack,Almonds,1,8000,8000,0,7000,1000
09/04/24,Food,Beverages,Lemon Tea,5,4000,20000,0,15000,5000
09/04/24,Food,Beverages,Ocha,2,4000,8000,0,7000,1000
09/04/24,Food,Beverages,Lychee Tea,3,6000,18000,0,15000,3000
09/04/24,Food,Beverages,Oolong Tea,1,6000,6000,0,5000,1000
09/04/24,Food,Beverages,Soda,3,5000,15000,0,12000,3000
09/05/24,Food,Food,Takoyaki,3,10000,30000,0,24000,6000
09/05/24,Food,Food,Steak,4,60000,240000,0,220000,20000
09/05/24,Food,Food,Rendang,1,10000,10000,0,8000,2000
09/05/24,Food,Food,Fried Chicken,10,3000,30000,0,20000,10000
09/05/24,Food,Food,Noodles,8,6000,48000,0,40000,8000
09/05/24,Food,Food,Salmon,4,15000,60000,0,56000,4000
09/05/24,Food,Food,Macaroni,1,5000,5000,0,4000,1000
09/05/24,Food,Food,Fish & Chips,3,30000,90000,0,81000,9000
09/05/24,Food,Food,Burger,2,15000,30000,0,28000,2000
09/05/24,Food,Food,Hotdog,3,10000,30000,0,27000,3000
09/05/24,Food,Food,Pasta,1,18000,18000,0,16000,2000
09/05/24,Food,Snack,Chips,2,5000,10000,0,8000,2000
09/05/24,Food,Snack,Popcorn,1,7000,7000,0,6500,500
09/05/24,Food,Snack,Almonds,1,8000,8000,0,7000,1000
09/05/24,Food,Beverages,Lemon Tea,5,4000,20000,0,15000,5000
09/05/24,Food,Beverages,Ocha,2,4000,8000,0,7000,1000
09/05/24,Food,Beverages,Lychee Tea,3,6000,18000,0,15000,3000
09/05/24,Food,Beverages,Oolong Tea,1,6000,6000,0,5000,1000
09/05/24,Food,Beverages,Soda,3,5000,15000,0,12000,3000
09/06/24,Food,Food,Takoyaki,3,10000,30000,0,24000,6000
09/06/24,Food,Food,Steak,4,60000,240000,0,220000,20000
09/06/24,Food,Food,Rendang,1,10000,10000,0,8000,2000
09/06/24,Food,Food,Fried Chicken,10,3000,30000,0,20000,10000
09/06/24,Food,Food,Noodles,8,6000,48000,0,40000,8000
09/06/24,Food,Food,Salmon,4,15000,60000,0,56000,4000
09/06/24,Food,Food,Macaroni,1,5000,5000,0,4000,1000
09/06/24,Food,Food,Fish & Chips,3,30000,90000,0,81000,9000
09/06/24,Food,Food,Burger,2,15000,30000,0,28000,2000
09/06/24,Food,Food,Hotdog,3,10000,30000,0,27000,3000
09/06/24,Food,Food,Pasta,1,18000,18000,0,16000,2000
09/06/24,Food,Snack,Chips,2,5000,10000,0,8000,2000
09/06/24,Food,Snack,Popcorn,1,7000,7000,0,6500,500
09/06/24,Food,Snack,Almonds,1,8000,8000,0,7000,1000
09/06/24,Food,Beverages,Lemon Tea,5,4000,20000,0,15000,5000
09/06/24,Food,Beverages,Ocha,2,4000,8000,0,7000,1000
09/06/24,Food,Beverages,Lychee Tea,3,6000,18000,0,15000,3000
09/06/24,Food,Beverages,Oolong Tea,1,6000,6000,0,5000,1000
09/06/24,Food,Beverages,Soda,3,5000,15000,0,12000,3000
09/07/24,Food,Food,Takoyaki,3,10000,30000,0,24000,6000
09/07/24,Food,Food,Steak,4,60000,240000,0,220000,20000
09/07/24,Food,Food,Rendang,1,10000,10000,0,8000,2000
09/07/24,Food,Food,Fried Chicken,10,3000,30000,0,20000,10000
09/07/24,Food,Food,Noodles,8,6000,48000,0,40000,8000
09/07/24,Food,Food,Salmon,4,15000,60000,0,56000,4000
09/07/24,Food,Food,Macaroni,1,5000,5000,0,4000,1000
09/07/24,Food,Food,Fish & Chips,3,30000,90000,0,81000,9000
09/07/24,Food,Food,Burger,2,15000,30000,0,28000,2000
09/07/24,Food,Food,Hotdog,3,10000,30000,0,27000,3000
09/07/24,Food,Food,Pasta,1,18000,18000,0,16000,2000
09/07/24,Food,Snack,Chips,2,5000,10000,0,8000,2000
09/07/24,Food,Snack,Popcorn,1,7000,7000,0,6500,500
09/07/24,Food,Snack,Almonds,1,8000,8000,0,7000,1000
09/07/24,Food,Beverages,Lemon Tea,5,4000,20000,0,15000,5000
09/07/24,Food,Beverages,Ocha,2,4000,8000,0,7000,1000
09/07/24,Food,Beverages,Lychee Tea,3,6000,18000,0,15000,3000
09/07/24,Food,Beverages,Oolong Tea,1,6000,6000,0,5000,1000
09/07/24,Food,Beverages,Soda,3,5000,15000,0,12000,3000
09/08/24,Food,Food,Takoyaki,3,10000,30000,0,24000,6000
09/08/24,Food,Food,Steak,4,60000,240000,0,220000,20000
09/08/24,Food,Food,Rendang,1,10000,10000,0,8000,2000
09/08/24,Food,Food,Fried Chicken,10,3000,30000,0,20000,10000
09/08/24,Food,Food,Noodles,8,6000,48000,0,40000,8000
09/08/24,Food,Food,Salmon,4,15000,60000,0,56000,4000
09/08/24,Food,Food,Macaroni,1,5000,5000,0,4000,1000
09/08/24,Food,Food,Fish & Chips,3,30000,90000,0,81000,9000
09/08/24,Food,Food,Burger,2,15000,30000,0,28000,2000
09/08/24,Food,Food,Hotdog,3,10000,30000,0,27000,3000
09/08/24,Food,Food,Pasta,1,18000,18000,0,16000,2000
09/08/24,Food,Snack,Chips,2,5000,10000,0,8000,2000
09/08/24,Food,Snack,Popcorn,1,7000,7000,0,6500,500
09/08/24,Food,Snack,Almonds,1,8000,8000,0,7000,1000
09/08/24,Food,Beverages,Lemon Tea,5,4000,20000,0,15000,5000
09/08/24,Food,Beverages,Ocha,2,4000,8000,0,7000,1000
09/08/24,Food,Beverages,Lychee Tea,3,6000,18000,0,15000,3000
09/08/24,Food,Beverages,Oolong Tea,1,6000,6000,0,5000,1000
09/08/24,Food,Beverages,Soda,3,5000,15000,0,12000,3000
09/09/24,Food,Food,Takoyaki,3,10000,30000,0,24000,6000
09/09/24,Food,Food,Steak,4,60000,240000,0,220000,20000
09/09/24,Food,Food,Rendang,1,10000,10000,0,8000,2000
09/09/24,Food,Food,Fried Chicken,10,3000,30000,0,20000,10000
09/09/24,Food,Food,Noodles,8,6000,48000,0,40000,8000
09/09/24,Food,Food,Salmon,4,15000,60000,0,56000,4000
09/09/24,Food,Food,Macaroni,1,5000,5000,0,4000,1000
09/09/24,Food,Food,Fish & Chips,3,30000,90000,0,81000,9000
09/09/24,Food,Food,Burger,2,15000,30000,0,28000,2000
09/09/24,Food,Food,Hotdog,3,10000,30000,0,27000,3000
09/09/24,Food,Food,Pasta,1,18000,18000,0,16000,2000
09/09/24,Food,Snack,Chips,2,5000,10000,0,8000,2000
09/09/24,Food,Snack,Popcorn,1,7000,7000,0,6500,500
09/09/24,Food,Snack,Almonds,1,8000,8000,0,7000,1000
09/09/24,Food,Beverages,Lemon Tea,5,4000,20000,0,15000,5000
09/09/24,Food,Beverages,Ocha,2,4000,8000,0,7000,1000
09/09/24,Food,Beverages,Lychee Tea,3,6000,18000,0,15000,3000
09/09/24,Food,Beverages,Oolong Tea,1,6000,6000,0,5000,1000
09/09/24,Food,Beverages,Soda,3,5000,15000,0,12000,3000
09/10/24,Food,Food,Takoyaki,3,10000,30000,0,24000,6000
09/10/24,Food,Food,Steak,4,60000,240000,0,220000,20000
09/10/24,Food,Food,Rendang,1,10000,10000,0,8000,2000
09/10/24,Food,Food,Fried Chicken,10,3000,30000,0,20000,10000
09/10/24,Food,Food,Noodles,8,6000,48000,0,40000,8000
09/10/24,Food,Food,Salmon,4,15000,60000,0,56000,4000
09/10/24,Food,Food,Macaroni,1,5000,5000,0,4000,1000
09/10/24,Food,Food,Fish & Chips,3,30000,90000,0,81000,9000
09/10/24,Food,Food,Burger,2,15000,30000,0,28000,2000
09/10/24,Food,Food,Hotdog,3,10000,30000,0,27000,3000
09/10/24,Food,Food,Pasta,1,18000,18000,0,16000,2000
09/10/24,Food,Snack,Chips,2,5000,10000,0,8000,2000
09/10/24,Food,Snack,Popcorn,1,7000,7000,0,6500,500
09/10/24,Food,Snack,Almonds,1,8000,8000,0,7000,1000
09/10/24,Food,Beverages,Lemon Tea,5,4000,20000,0,15000,5000
09/10/24,Food,Beverages,Ocha,2,4000,8000,0,7000,1000
09/10/24,Food,Beverages,Lychee Tea,3,6000,18000,0,15000,3000
09/10/24,Food,Beverages,Oolong Tea,1,6000,6000,0,5000,1000
09/10/24,Food,Beverages,Soda,3,5000,15000,0,12000,3000
09/11/24,Food,Food,Takoyaki,3,10000,30000,0,24000,6000
09/11/24,Food,Food,Steak,4,60000,240000,0,220000,20000
09/11/24,Food,Food,Rendang,1,10000,10000,0,8000,2000
09/11/24,Food,Food,Fried Chicken,10,3000,30000,0,20000,10000
09/11/24,Food,Food,Noodles,8,6000,48000,0,40000,8000
09/11/24,Food,Food,Salmon,4,15000,60000,0,56000,4000
09/11/24,Food,Food,Macaroni,1,5000,5000,0,4000,1000
09/11/24,Food,Food,Fish & Chips,3,30000,90000,0,81000,9000
09/11/24,Food,Food,Burger,2,15000,30000,0,28000,2000
09/11/24,Food,Food,Hotdog,3,10000,30000,0,27000,3000
09/11/24,Food,Food,Pasta,1,18000,18000,0,16000,2000
09/11/24,Food,Snack,Chips,2,5000,10000,0,8000,2000
09/11/24,Food,Snack,Popcorn,1,7000,7000,0,6500,500
09/11/24,Food,Snack,Almonds,1,8000,8000,0,7000,1000
09/11/24,Food,Beverages,Lemon Tea,5,4000,20000,0,15000,5000
09/11/24,Food,Beverages,Ocha,2,4000,8000,0,7000,1000
09/11/24,Food,Beverages,Lychee Tea,3,6000,18000,0,15000,3000
09/11/24,Food,Beverages,Oolong Tea,1,6000,6000,0,5000,1000
09/11/24,Food,Beverages,Soda,3,5000,15000,0,12000,3000
09/12/24,Food,Food,Takoyaki,3,10000,30000,0,24000,6000
09/12/24,Food,Food,Steak,4,60000,240000,0,220000,20000
09/12/24,Food,Food,Rendang,1,10000,10000,0,8000,2000
09/12/24,Food,Food,Fried Chicken,10,3000,30000,0,20000,10000
09/12/24,Food,Food,Noodles,8,6000,48000,0,40000,8000
09/12/24,Food,Food,Salmon,4,15000,60000,0,56000,4000
09/12/24,Food,Food,Macaroni,1,5000,5000,0,4000,1000
09/12/24,Food,Food,Fish & Chips,3,30000,90000,0,81000,9000
09/12/24,Food,Food,Burger,2,15000,30000,0,28000,2000
09/12/24,Food,Food,Hotdog,3,10000,30000,0,27000,3000
09/12/24,Food,Food,Pasta,1,18000,18000,0,16000,2000
09/12/24,Food,Snack,Chips,2,5000,10000,0,8000,2000
09/12/24,Food,Snack,Popcorn,1,7000,7000,0,6500,500
09/12/24,Food,Snack,Almonds,1,8000,8000,0,7000,1000
09/12/24,Food,Beverages,Lemon Tea,5,4000,20000,0,15000,5000
09/12/24,Food,Beverages,Ocha,2,4000,8000,0,7000,1000
09/12/24,Food,Beverages,Lychee Tea,3,6000,18000,0,15000,3000
09/12/24,Food,Beverages,Oolong Tea,1,6000,6000,0,5000,1000
09/12/24,Food,Beverages,Soda,3,5000,15000,0,12000,3000
09/13/24,Food,Food,Takoyaki,3,10000,30000,0,24000,6000
09/13/24,Food,Food,Steak,4,60000,240000,0,220000,20000
09/13/24,Food,Food,Rendang,1,10000,10000,0,8000,2000
09/13/24,Food,Food,Fried Chicken,10,3000,30000,0,20000,10000
09/13/24,Food,Food,Noodles,8,6000,48000,0,40000,8000
09/13/24,Food,Food,Salmon,4,15000,60000,0,56000,4000
09/13/24,Food,Food,Macaroni,1,5000,5000,0,4000,1000
09/13/24,Food,Food,Fish & Chips,3,30000,90000,0,81000,9000
09/13/24,Food,Food,Burger,2,15000,30000,0,28000,2000
09/13/24,Food,Food,Hotdog,3,10000,30000,0,27000,3000
09/13/24,Food,Food,Pasta,1,18000,18000,0,16000,2000
09/13/24,Food,Snack,Chips,2,5000,10000,0,8000,2000
09/13/24,Food,Snack,Popcorn,1,7000,7000,0,6500,500
09/13/24,Food,Snack,Almonds,1,8000,8000,0,7000,1000
09/13/24,Food,Beverages,Lemon Tea,5,4000,20000,0,15000,5000
09/13/24,Food,Beverages,Ocha,2,4000,8000,0,7000,1000
09/13/24,Food,Beverages,Lychee Tea,3,6000,18000,0,15000,3000
09/13/24,Food,Beverages,Oolong Tea,1,6000,6000,0,5000,1000
09/13/24,Food,Beverages,Soda,3,5000,15000,0,12000,3000
09/14/24,Food,Food,Takoyaki,3,10000,30000,0,24000,6000
09/14/24,Food,Food,Steak,4,60000,240000,0,220000,20000
09/14/24,Food,Food,Rendang,1,10000,10000,0,8000,2000
09/14/24,Food,Food,Fried Chicken,10,3000,30000,0,20000,10000
09/14/24,Food,Food,Noodles,8,6000,48000,0,40000,8000
09/14/24,Food,Food,Salmon,4,15000,60000,0,56000,4000
09/14/24,Food,Food,Macaroni,1,5000,5000,0,4000,1000
09/14/24,Food,Food,Fish & Chips,3,30000,90000,0,81000,9000
09/14/24,Food,Food,Burger,2,15000,30000,0,28000,2000
09/14/24,Food,Food,Hotdog,3,10000,30000,0,27000,3000
09/14/24,Food,Food,Pasta,1,18000,18000,0,16000,2000
09/14/24,Food,Snack,Chips,2,5000,10000,0,8000,2000
09/14/24,Food,Snack,Popcorn,1,7000,7000,0,6500,500
09/14/24,Food,Snack,Almonds,1,8000,8000,0,7000,1000
09/14/24,Food,Beverages,Lemon Tea,5,4000,20000,0,15000,5000
09/14/24,Food,Beverages,Ocha,2,4000,8000,0,7000,1000
09/14/24,Food,Beverages,Lychee Tea,3,6000,18000,0,15000,3000
09/14/24,Food,Beverages,Oolong Tea,1,6000,6000,0,5000,1000
09/14/24,Food,Beverages,Soda,3,5000,15000,0,12000,3000
09/15/24,Food,Food,Takoyaki,3,10000,30000,0,24000,6000
09/15/24,Food,Food,Steak,4,60000,240000,0,220000,20000
09/15/24,Food,Food,Rendang,1,10000,10000,0,8000,2000
09/15/24,Food,Food,Fried Chicken,10,3000,30000,0,20000,10000
09/15/24,Food,Food,Noodles,8,6000,48000,0,40000,8000
09/15/24,Food,Food,Salmon,4,15000,60000,0,56000,4000
09/15/24,Food,Food,Macaroni,1,5000,5000,0,4000,1000
09/15/24,Food,Food,Fish & Chips,3,30000,90000,0,81000,9000
09/15/24,Food,Food,Burger,2,15000,30000,0,28000,2000
09/15/24,Food,Food,Hotdog,3,10000,30000,0,27000,3000
09/15/24,Food,Food,Pasta,1,18000,18000,0,16000,2000
09/15/24,Food,Snack,Chips,2,5000,10000,0,8000,2000
09/15/24,Food,Snack,Popcorn,1,7000,7000,0,6500,500
09/15/24,Food,Snack,Almonds,1,8000,8000,0,7000,1000
09/15/24,Food,Beverages,Lemon Tea,5,4000,20000,0,15000,5000
09/15/24,Food,Beverages,Ocha,2,4000,8000,0,7000,1000
09/15/24,Food,Beverages,Lychee Tea,3,6000,18000,0,15000,3000
09/15/24,Food,Beverages,Oolong Tea,1,6000,6000,0,5000,1000
09/15/24,Food,Beverages,Soda,3,5000,15000,0,12000,3000
09/16/24,Food,Food,Takoyaki,3,10000,30000,0,24000,6000
09/16/24,Food,Food,Steak,4,60000,240000,0,220000,20000
09/16/24,Food,Food,Rendang,1,10000,10000,0,8000,2000
09/16/24,Food,Food,Fried Chicken,10,3000,30000,0,20000,10000
09/16/24,Food,Food,Noodles,8,6000,48000,0,40000,8000
09/16/24,Food,Food,Salmon,4,15000,60000,0,56000,4000
09/16/24,Food,Food,Macaroni,1,5000,5000,0,4000,1000
09/16/24,Food,Food,Fish & Chips,3,30000,90000,0,81000,9000
09/16/24,Food,Food,Burger,2,15000,30000,0,28000,2000
09/16/24,Food,Food,Hotdog,3,10000,30000,0,27000,3000
09/16/24,Food,Food,Pasta,1,18000,18000,0,16000,2000
09/16/24,Food,Snack,Chips,2,5000,10000,0,8000,2000
09/16/24,Food,Snack,Popcorn,1,7000,7000,0,6500,500
09/16/24,Food,Snack,Almonds,1,8000,8000,0,7000,1000
09/16/24,Food,Beverages,Lemon Tea,5,4000,20000,0,15000,5000
09/16/24,Food,Beverages,Ocha,2,4000,8000,0,7000,1000
09/16/24,Food,Beverages,Lychee Tea,3,6000,18000,0,15000,3000
09/16/24,Food,Beverages,Oolong Tea,1,6000,6000,0,5000,1000
09/16/24,Food,Beverages,Soda,3,5000,15000,0,12000,3000
09/17/24,Food,Food,Takoyaki,3,10000,30000,0,24000,6000
09/17/24,Food,Food,Steak,4,60000,240000,0,220000,20000
09/17/24,Food,Food,Rendang,1,10000,10000,0,8000,2000
09/17/24,Food,Food,Fried Chicken,10,3000,30000,0,20000,10000
09/17/24,Food,Food,Noodles,8,6000,48000,0,40000,8000
09/17/24,Food,Food,Salmon,4,15000,60000,0,56000,4000
09/17/24,Food,Food,Macaroni,1,5000,5000,0,4000,1000
09/17/24,Food,Food,Fish & Chips,3,30000,90000,0,81000,9000
09/17/24,Food,Food,Burger,2,15000,30000,0,28000,2000
09/17/24,Food,Food,Hotdog,3,10000,30000,0,27000,3000
09/17/24,Food,Food,Pasta,1,18000,18000,0,16000,2000
09/17/24,Food,Snack,Chips,2,5000,10000,0,8000,2000
09/17/24,Food,Snack,Popcorn,1,7000,7000,0,6500,500
09/17/24,Food,Snack,Almonds,1,8000,8000,0,7000,1000
09/17/24,Food,Beverages,Lemon Tea,5,4000,20000,0,15000,5000
09/17/24,Food,Beverages,Ocha,2,4000,8000,0,7000,1000
09/17/24,Food,Beverages,Lychee Tea,3,6000,18000,0,15000,3000
09/17/24,Food,Beverages,Oolong Tea,1,6000,6000,0,5000,1000
09/17/24,Food,Beverages,Soda,3,5000,15000,0,12000,3000
09/18/24,Food,Food,Takoyaki,3,10000,30000,0,24000,6000
09/18/24,Food,Food,Steak,4,60000,240000,0,220000,20000
09/18/24,Food,Food,Rendang,1,10000,10000,0,8000,2000
09/18/24,Food,Food,Fried Chicken,10,3000,30000,0,20000,10000
09/18/24,Food,Food,Noodles,8,6000,48000,0,40000,8000
09/18/24,Food,Food,Salmon,4,15000,60000,0,56000,4000
09/18/24,Food,Food,Macaroni,1,5000,5000,0,4000,1000
09/18/24,Food,Food,Fish & Chips,3,30000,90000,0,81000,9000
09/18/24,Food,Food,Burger,2,15000,30000,0,28000,2000
09/18/24,Food,Food,Hotdog,3,10000,30000,0,27000,3000
09/18/24,Food,Food,Pasta,1,18000,18000,0,16000,2000
09/18/24,Food,Snack,Chips,2,5000,10000,0,8000,2000
09/18/24,Food,Snack,Popcorn,1,7000,7000,0,6500,500
09/18/24,Food,Snack,Almonds,1,8000,8000,0,7000,1000
09/18/24,Food,Beverages,Lemon Tea,5,4000,20000,0,15000,5000
09/18/24,Food,Beverages,Ocha,2,4000,8000,0,7000,1000
09/18/24,Food,Beverages,Lychee Tea,3,6000,18000,0,15000,3000
09/18/24,Food,Beverages,Oolong Tea,1,6000,6000,0,5000,1000
09/18/24,Food,Beverages,Soda,3,5000,15000,0,12000,3000
09/19/24,Food,Food,Takoyaki,3,10000,30000,0,24000,6000
09/19/24,Food,Food,Steak,4,60000,240000,0,220000,20000
09/19/24,Food,Food,Rendang,1,10000,10000,0,8000,2000
09/19/24,Food,Food,Fried Chicken,10,3000,30000,0,20000,10000
09/19/24,Food,Food,Noodles,8,6000,48000,0,40000,8000
09/19/24,Food,Food,Salmon,4,15000,60000,0,56000,4000
09/19/24,Food,Food,Macaroni,1,5000,5000,0,4000,1000
09/19/24,Food,Food,Fish & Chips,3,30000,90000,0,81000,9000
09/19/24,Food,Food,Burger,2,15000,30000,0,28000,2000
09/19/24,Food,Food,Hotdog,3,10000,30000,0,27000,3000
09/19/24,Food,Food,Pasta,1,18000,18000,0,16000,2000
09/19/24,Food,Snack,Chips,2,5000,10000,0,8000,2000
09/19/24,Food,Snack,Popcorn,1,7000,7000,0,6500,500
09/19/24,Food,Snack,Almonds,1,8000,8000,0,7000,1000
09/19/24,Food,Beverages,Lemon Tea,5,4000,20000,0,15000,5000
09/19/24,Food,Beverages,Ocha,2,4000,8000,0,7000,1000
09/19/24,Food,Beverages,Lychee Tea,3,6000,18000,0,15000,3000
09/19/24,Food,Beverages,Oolong Tea,1,6000,6000,0,5000,1000
09/19/24,Food,Beverages,Soda,3,5000,15000,0,12000,3000
09/20/24,Food,Food,Takoyaki,3,10000,30000,0,24000,6000
09/20/24,Food,Food,Steak,4,60000,240000,0,220000,20000
09/20/24,Food,Food,Rendang,1,10000,10000,0,8000,2000
09/20/24,Food,Food,Fried Chicken,10,3000,30000,0,20000,10000
09/20/24,Food,Food,Noodles,8,6000,48000,0,40000,8000
09/20/24,Food,Food,Salmon,4,15000,60000,0,56000,4000
09/20/24,Food,Food,Macaroni,1,5000,5000,0,4000,1000
09/20/24,Food,Food,Fish & Chips,3,30000,90000,0,81000,9000
09/20/24,Food,Food,Burger,2,15000,30000,0,28000,2000
09/20/24,Food,Food,Hotdog,3,10000,30000,0,27000,3000
09/20/24,Food,Food,Pasta,1,18000,18000,0,16000,2000
09/20/24,Food,Snack,Chips,2,5000,10000,0,8000,2000
09/20/24,Food,Snack,Popcorn,1,7000,7000,0,6500,500
09/20/24,Food,Snack,Almonds,1,8000,8000,0,7000,1000
09/20/24,Food,Beverages,Lemon Tea,5,4000,20000,0,15000,5000
09/20/24,Food,Beverages,Ocha,2,4000,8000,0,7000,1000
09/20/24,Food,Beverages,Lychee Tea,3,6000,18000,0,15000,3000
09/20/24,Food,Beverages,Oolong Tea,1,6000,6000,0,5000,1000
09/20/24,Food,Beverages,Soda,3,5000,15000,0,12000,3000
09/21/24,Food,Food,Takoyaki,3,10000,30000,0,24000,6000
09/21/24,Food,Food,Steak,4,60000,240000,0,220000,20000
09/21/24,Food,Food,Rendang,1,10000,10000,0,8000,2000
09/21/24,Food,Food,Fried Chicken,10,3000,30000,0,20000,10000
09/21/24,Food,Food,Noodles,8,6000,48000,0,40000,8000
09/21/24,Food,Food,Salmon,4,15000,60000,0,56000,4000
09/21/24,Food,Food,Macaroni,1,5000,5000,0,4000,1000
09/21/24,Food,Food,Fish & Chips,3,30000,90000,0,81000,9000
09/21/24,Food,Food,Burger,2,15000,30000,0,28000,2000
09/21/24,Food,Food,Hotdog,3,10000,30000,0,27000,3000
09/21/24,Food,Food,Pasta,1,18000,18000,0,16000,2000
09/21/24,Food,Snack,Chips,2,5000,10000,0,8000,2000
09/21/24,Food,Snack,Popcorn,1,7000,7000,0,6500,500
09/21/24,Food,Snack,Almonds,1,8000,8000,0,7000,1000
09/21/24,Food,Beverages,Lemon Tea,5,4000,20000,0,15000,5000
09/21/24,Food,Beverages,Ocha,2,4000,8000,0,7000,1000
09/21/24,Food,Beverages,Lychee Tea,3,6000,18000,0,15000,3000
09/21/24,Food,Beverages,Oolong Tea,1,6000,6000,0,5000,1000
09/21/24,Food,Beverages,Soda,3,5000,15000,0,12000,3000
09/22/24,Food,Food,Takoyaki,3,10000,30000,0,24000,6000
09/22/24,Food,Food,Steak,4,60000,240000,0,220000,20000
09/22/24,Food,Food,Rendang,1,10000,10000,0,8000,2000
09/22/24,Food,Food,Fried Chicken,10,3000,30000,0,20000,10000
09/22/24,Food,Food,Noodles,8,6000,48000,0,40000,8000
09/22/24,Food,Food,Salmon,4,15000,60000,0,56000,4000
09/22/24,Food,Food,Macaroni,1,5000,5000,0,4000,1000
09/22/24,Food,Food,Fish & Chips,3,30000,90000,0,81000,9000
09/22/24,Food,Food,Burger,2,15000,30000,0,28000,2000
09/22/24,Food,Food,Hotdog,3,10000,30000,0,27000,3000
09/22/24,Food,Food,Pasta,1,18000,18000,0,16000,2000
09/22/24,Food,Snack,Chips,2,5000,10000,0,8000,2000
09/22/24,Food,Snack,Popcorn,1,7000,7000,0,6500,500
09/22/24,Food,Snack,Almonds,1,8000,8000,0,7000,1000
09/22/24,Food,Beverages,Lemon Tea,5,4000,20000,0,15000,5000
09/22/24,Food,Beverages,Ocha,2,4000,8000,0,7000,1000
09/22/24,Food,Beverages,Lychee Tea,3,6000,18000,0,15000,3000
09/22/24,Food,Beverages,Oolong Tea,1,6000,6000,0,5000,1000
09/22/24,Food,Beverages,Soda,3,5000,15000,0,12000,3000
09/23/24,Food,Food,Takoyaki,3,10000,30000,0,24000,6000
09/23/24,Food,Food,Steak,4,60000,240000,0,220000,20000
09/23/24,Food,Food,Rendang,1,10000,10000,0,8000,2000
09/23/24,Food,Food,Fried Chicken,10,3000,30000,0,20000,10000
09/23/24,Food,Food,Noodles,8,6000,48000,0,40000,8000
09/23/24,Food,Food,Salmon,4,15000,60000,0,56000,4000
09/23/24,Food,Food,Macaroni,1,5000,5000,0,4000,1000
09/23/24,Food,Food,Fish & Chips,3,30000,90000,0,81000,9000
09/23/24,Food,Food,Burger,2,15000,30000,0,28000,2000
09/23/24,Food,Food,Hotdog,3,10000,30000,0,27000,3000
09/23/24,Food,Food,Pasta,1,18000,18000,0,16000,2000
09/23/24,Food,Snack,Chips,2,5000,10000,0,8000,2000
09/23/24,Food,Snack,Popcorn,1,7000,7000,0,6500,500
09/23/24,Food,Snack,Almonds,1,8000,8000,0,7000,1000
09/23/24,Food,Beverages,Lemon Tea,5,4000,20000,0,15000,5000
09/23/24,Food,Beverages,Ocha,2,4000,8000,0,7000,1000
09/23/24,Food,Beverages,Lychee Tea,3,6000,18000,0,15000,3000
09/23/24,Food,Beverages,Oolong Tea,1,6000,6000,0,5000,1000
09/23/24,Food,Beverages,Soda,3,5000,15000,0,12000,3000
09/24/24,Food,Food,Takoyaki,3,10000,30000,0,24000,6000
09/24/24,Food,Food,Steak,4,60000,240000,0,220000,20000
09/24/24,Food,Food,Rendang,1,10000,10000,0,8000,2000
09/24/24,Food,Food,Fried Chicken,10,3000,30000,0,20000,10000
09/24/24,Food,Food,Noodles,8,6000,48000,0,40000,8000
09/24/24,Food,Food,Salmon,4,15000,60000,0,56000,4000
09/24/24,Food,Food,Macaroni,1,5000,5000,0,4000,1000
09/24/24,Food,Food,Fish & Chips,3,30000,90000,0,81000,9000
09/24/24,Food,Food,Burger,2,15000,30000,0,28000,2000
09/24/24,Food,Food,Hotdog,3,10000,30000,0,27000,3000
09/24/24,Food,Food,Pasta,1,18000,18000,0,16000,2000
09/24/24,Food,Snack,Chips,2,5000,10000,0,8000,2000
09/24/24,Food,Snack,Popcorn,1,7000,7000,0,6500,500
09/24/24,Food,Snack,Almonds,1,8000,8000,0,7000,1000
09/24/24,Food,Beverages,Lemon Tea,5,4000,20000,0,15000,5000
09/24/24,Food,Beverages,Ocha,2,4000,8000,0,7000,1000
09/24/24,Food,Beverages,Lychee Tea,3,6000,18000,0,15000,3000
09/24/24,Food,Beverages,Oolong Tea,1,6000,6000,0,5000,1000
09/24/24,Food,Beverages,Soda,3,5000,15000,0,12000,3000
09/25/24,Food,Food,Takoyaki,3,10000,30000,0,24000,6000
09/25/24,Food,Food,Steak,4,60000,240000,0,220000,20000
09/25/24,Food,Food,Rendang,1,10000,10000,0,8000,2000
09/25/24,Food,Food,Fried Chicken,10,3000,30000,0,20000,10000
09/25/24,Food,Food,Noodles,8,6000,48000,0,40000,8000
09/25/24,Food,Food,Salmon,4,15000,60000,0,56000,4000
09/25/24,Food,Food,Macaroni,1,5000,5000,0,4000,1000
09/25/24,Food,Food,Fish & Chips,3,30000,90000,0,81000,9000
09/25/24,Food,Food,Burger,2,15000,30000,0,28000,2000
09/25/24,Food,Food,Hotdog,3,10000,30000,0,27000,3000
09/25/24,Food,Food,Pasta,1,18000,18000,0,16000,2000
09/25/24,Food,Snack,Chips,2,5000,10000,0,8000,2000
09/25/24,Food,Snack,Popcorn,1,7000,7000,0,6500,500
09/25/24,Food,Snack,Almonds,1,8000,8000,0,7000,1000
09/25/24,Food,Beverages,Lemon Tea,5,4000,20000,0,15000,5000
09/25/24,Food,Beverages,Ocha,2,4000,8000,0,7000,1000
09/25/24,Food,Beverages,Lychee Tea,3,6000,18000,0,15000,3000
09/25/24,Food,Beverages,Oolong Tea,1,6000,6000,0,5000,1000
09/25/24,Food,Beverages,Soda,3,5000,15000,0,12000,3000
09/26/24,Food,Food,Takoyaki,3,10000,30000,0,24000,6000
09/26/24,Food,Food,Steak,4,60000,240000,0,220000,20000
09/26/24,Food,Food,Rendang,1,10000,10000,0,8000,2000
09/26/24,Food,Food,Fried Chicken,10,3000,30000,0,20000,10000
09/26/24,Food,Food,Noodles,8,6000,48000,0,40000,8000
09/26/24,Food,Food,Salmon,4,15000,60000,0,56000,4000
09/26/24,Food,Food,Macaroni,1,5000,5000,0,4000,1000
09/26/24,Food,Food,Fish & Chips,3,30000,90000,0,81000,9000
09/26/24,Food,Food,Burger,2,15000,30000,0,28000,2000
09/26/24,Food,Food,Hotdog,3,10000,30000,0,27000,3000
09/26/24,Food,Food,Pasta,1,18000,18000,0,16000,2000
09/26/24,Food,Snack,Chips,2,5000,10000,0,8000,2000
09/26/24,Food,Snack,Popcorn,1,7000,7000,0,6500,500
09/26/24,Food,Snack,Almonds,1,8000,8000,0,7000,1000
09/26/24,Food,Beverages,Lemon Tea,5,4000,20000,0,15000,5000
09/26/24,Food,Beverages,Ocha,2,4000,8000,0,7000,1000
09/26/24,Food,Beverages,Lychee Tea,3,6000,18000,0,15000,3000
09/26/24,Food,Beverages,Oolong Tea,1,6000,6000,0,5000,1000
09/26/24,Food,Beverages,Soda,3,5000,15000,0,12000,3000
09/27/24,Food,Food,Takoyaki,3,10000,30000,0,24000,6000
09/27/24,Food,Food,Steak,4,60000,240000,0,220000,20000
09/27/24,Food,Food,Rendang,1,10000,10000,0,8000,2000
09/27/24,Food,Food,Fried Chicken,10,3000,30000,0,20000,10000
09/27/24,Food,Food,Noodles,8,6000,48000,0,40000,8000
09/27/24,Food,Food,Salmon,4,15000,60000,0,56000,4000
09/27/24,Food,Food,Macaroni,1,5000,5000,0,4000,1000
09/27/24,Food,Food,Fish & Chips,3,30000,90000,0,81000,9000
09/27/24,Food,Food,Burger,2,15000,30000,0,28000,2000
09/27/24,Food,Food,Hotdog,3,10000,30000,0,27000,3000
09/27/24,Food,Food,Pasta,1,18000,18000,0,16000,2000
09/27/24,Food,Snack,Chips,2,5000,10000,0,8000,2000
09/27/24,Food,Snack,Popcorn,1,7000,7000,0,6500,500
09/27/24,Food,Snack,Almonds,1,8000,8000,0,7000,1000
09/27/24,Food,Beverages,Lemon Tea,5,4000,20000,0,15000,5000
09/27/24,Food,Beverages,Ocha,2,4000,8000,0,7000,1000
09/27/24,Food,Beverages,Lychee Tea,3,6000,18000,0,15000,3000
09/27/24,Food,Beverages,Oolong Tea,1,6000,6000,0,5000,1000
09/27/24,Food,Beverages,Soda,3,5000,15000,0,12000,3000
09/28/24,Food,Food,Takoyaki,3,10000,30000,0,24000,6000
09/28/24,Food,Food,Steak,4,60000,240000,0,220000,20000
09/28/24,Food,Food,Rendang,1,10000,10000,0,8000,2000
09/28/24,Food,Food,Fried Chicken,10,3000,30000,0,20000,10000
09/28/24,Food,Food,Noodles,8,6000,48000,0,40000,8000
09/28/24,Food,Food,Salmon,4,15000,60000,0,56000,4000
09/28/24,Food,Food,Macaroni,1,5000,5000,0,4000,1000
09/28/24,Food,Food,Fish & Chips,3,30000,90000,0,81000,9000
09/28/24,Food,Food,Burger,2,15000,30000,0,28000,2000
09/28/24,Food,Food,Hotdog,3,10000,30000,0,27000,3000
09/28/24,Food,Food,Pasta,1,18000,18000,0,16000,2000
09/28/24,Food,Snack,Chips,2,5000,10000,0,8000,2000
09/28/24,Food,Snack,Popcorn,1,7000,7000,0,6500,500
09/28/24,Food,Snack,Almonds,1,8000,8000,0,7000,1000
09/28/24,Food,Beverages,Lemon Tea,5,4000,20000,0,15000,5000
09/28/24,Food,Beverages,Ocha,2,4000,8000,0,7000,1000
09/28/24,Food,Beverages,Lychee Tea,3,6000,18000,0,15000,3000
09/28/24,Food,Beverages,Oolong Tea,1,6000,6000,0,5000,1000
09/28/24,Food,Beverages,Soda,3,5000,15000,0,12000,3000
09/29/24,Food,Food,Takoyaki,3,10000,30000,0,24000,6000
09/29/24,Food,Food,Steak,4,60000,240000,0,220000,20000
09/29/24,Food,Food,Rendang,1,10000,10000,0,8000,2000
09/29/24,Food,Food,Fried Chicken,10,3000,30000,0,20000,10000
09/29/24,Food,Food,Noodles,8,6000,48000,0,40000,8000
09/29/24,Food,Food,Salmon,4,15000,60000,0,56000,4000
09/29/24,Food,Food,Macaroni,1,5000,5000,0,4000,1000
09/29/24,Food,Food,Fish & Chips,3,30000,90000,0,81000,9000
09/29/24,Food,Food,Burger,2,15000,30000,0,28000,2000
09/29/24,Food,Food,Hotdog,3,10000,30000,0,27000,3000
09/29/24,Food,Food,Pasta,1,18000,18000,0,16000,2000
09/29/24,Food,Snack,Chips,2,5000,10000,0,8000,2000
09/29/24,Food,Snack,Popcorn,1,7000,7000,0,6500,500
09/29/24,Food,Snack,Almonds,1,8000,8000,0,7000,1000
09/29/24,Food,Beverages,Lemon Tea,5,4000,20000,0,15000,5000
09/29/24,Food,Beverages,Ocha,2,4000,8000,0,7000,1000
09/29/24,Food,Beverages,Lychee Tea,3,6000,18000,0,15000,3000
09/29/24,Food,Beverages,Oolong Tea,1,6000,6000,0,5000,1000
09/29/24,Food,Beverages,Soda,3,5000,15000,0,12000,3000
09/30/24,Food,Food,Takoyaki,3,10000,30000,0,24000,6000
09/30/24,Food,Food,Steak,4,60000,240000,0,220000,20000
09/30/24,Food,Food,Rendang,1,10000,10000,0,8000,2000
09/30/24,Food,Food,Fried Chicken,10,3000,30000,0,20000,10000
09/30/24,Food,Food,Noodles,8,6000,48000,0,40000,8000
09/30/24,Food,Food,Salmon,4,15000,60000,0,56000,4000
09/30/24,Food,Food,Macaroni,1,5000,5000,0,4000,1000
09/30/24,Food,Food,Fish & Chips,3,30000,90000,0,81000,9000
09/30/24,Food,Food,Burger,2,15000,30000,0,28000,2000
09/30/24,Food,Food,Hotdog,3,10000,30000,0,27000,3000
09/30/24,Food,Food,Pasta,1,18000,18000,0,16000,2000
09/30/24,Food,Snack,Chips,2,5000,10000,0,8000,2000
09/30/24,Food,Snack,Popcorn,1,7000,7000,0,6500,500
09/30/24,Food,Snack,Almonds,1,8000,8000,0,7000,1000
09/30/24,Food,Beverages,Lemon Tea,5,4000,20000,0,15000,5000
09/30/24,Food,Beverages,Ocha,2,4000,8000,0,7000,1000
09/30/24,Food,Beverages,Lychee Tea,3,6000,18000,0,15000,3000
09/30/24,Food,Beverages,Oolong Tea,1,6000,6000,0,5000,1000
09/30/24,Food,Beverages,Soda,3,5000,15000,0,12000,3000
10/01/24,Food,Food,Takoyaki,3,10000,30000,0,24000,6000
10/01/24,Food,Food,Steak,4,60000,240000,0,220000,20000
10/01/24,Food,Food,Rendang,1,10000,10000,0,8000,2000
10/01/24,Food,Food,Fried Chicken,10,3000,30000,0,20000,10000
10/01/24,Food,Food,Noodles,8,6000,48000,0,40000,8000
10/01/24,Food,Food,Salmon,4,15000,60000,0,56000,4000
10/01/24,Food,Food,Macaroni,1,5000,5000,0,4000,1000
10/01/24,Food,Food,Fish & Chips,3,30000,90000,0,81000,9000
10/01/24,Food,Food,Burger,2,15000,30000,0,28000,2000
10/01/24,Food,Food,Hotdog,3,10000,30000,0,27000,3000
10/01/24,Food,Food,Pasta,1,18000,18000,0,16000,2000
10/01/24,Food,Snack,Chips,2,5000,10000,0,8000,2000
10/01/24,Food,Snack,Popcorn,1,7000,7000,0,6500,500
10/01/24,Food,Snack,Almonds,1,8000,8000,0,7000,1000
10/01/24,Food,Beverages,Lemon Tea,5,4000,20000,0,15000,5000
10/01/24,Food,Beverages,Ocha,2,4000,8000,0,7000,1000
10/01/24,Food,Beverages,Lychee Tea,3,6000,18000,0,15000,3000
10/01/24,Food,Beverages,Oolong Tea,1,6000,6000,0,5000,1000
10/01/24,Food,Beverages,Soda,3,5000,15000,0,12000,3000
10/02/24,Food,Food,Takoyaki,3,10000,30000,0,24000,6000
10/02/24,Food,Food,Steak,4,60000,240000,0,220000,20000
10/02/24,Food,Food,Rendang,1,10000,10000,0,8000,2000
10/02/24,Food,Food,Fried Chicken,10,3000,30000,0,20000,10000
10/02/24,Food,Food,Noodles,8,6000,48000,0,40000,8000
10/02/24,Food,Food,Salmon,4,15000,60000,0,56000,4000
10/02/24,Food,Food,Macaroni,1,5000,5000,0,4000,1000
10/02/24,Food,Food,Fish & Chips,3,30000,90000,0,81000,9000
10/02/24,Food,Food,Burger,2,15000,30000,0,28000,2000
10/02/24,Food,Food,Hotdog,3,10000,30000,0,27000,3000
10/02/24,Food,Food,Pasta,1,18000,18000,0,16000,2000
10/02/24,Food,Snack,Chips,2,5000,10000,0,8000,2000
10/02/24,Food,Snack,Popcorn,1,7000,7000,0,6500,500
10/02/24,Food,Snack,Almonds,1,8000,8000,0,7000,1000
10/02/24,Food,Beverages,Lemon Tea,5,4000,20000,0,15000,5000
10/02/24,Food,Beverages,Ocha,2,4000,8000,0,7000,1000
10/02/24,Food,Beverages,Lychee Tea,3,6000,18000,0,15000,3000
10/02/24,Food,Beverages,Oolong Tea,1,6000,6000,0,5000,1000
10/02/24,Food,Beverages,Soda,3,5000,15000,0,12000,3000
10/03/24,Food,Food,Takoyaki,3,10000,30000,0,24000,6000
10/03/24,Food,Food,Steak,4,60000,240000,0,220000,20000
10/03/24,Food,Food,Rendang,1,10000,10000,0,8000,2000
10/03/24,Food,Food,Fried Chicken,10,3000,30000,0,20000,10000
10/03/24,Food,Food,Noodles,8,6000,48000,0,40000,8000
10/03/24,Food,Food,Salmon,4,15000,60000,0,56000,4000
10/03/24,Food,Food,Macaroni,1,5000,5000,0,4000,1000
10/03/24,Food,Food,Fish & Chips,3,30000,90000,0,81000,9000
10/03/24,Food,Food,Burger,2,15000,30000,0,28000,2000
10/03/24,Food,Food,Hotdog,3,10000,30000,0,27000,3000
10/03/24,Food,Food,Pasta,1,18000,18000,0,16000,2000
10/03/24,Food,Snack,Chips,2,5000,10000,0,8000,2000
10/03/24,Food,Snack,Popcorn,1,7000,7000,0,6500,500
10/03/24,Food,Snack,Almonds,1,8000,8000,0,7000,1000
10/03/24,Food,Beverages,Lemon Tea,5,4000,20000,0,15000,5000
10/03/24,Food,Beverages,Ocha,2,4000,8000,0,7000,1000
10/03/24,Food,Beverages,Lychee Tea,3,6000,18000,0,15000,3000
10/03/24,Food,Beverages,Oolong Tea,1,6000,6000,0,5000,1000
10/03/24,Food,Beverages,Soda,3,5000,15000,0,12000,3000
10/04/24,Food,Food,Takoyaki,3,10000,30000,0,24000,6000
10/04/24,Food,Food,Steak,4,60000,240000,0,220000,20000
10/04/24,Food,Food,Rendang,1,10000,10000,0,8000,2000
10/04/24,Food,Food,Fried Chicken,10,3000,30000,0,20000,10000
10/04/24,Food,Food,Noodles,8,6000,48000,0,40000,8000
10/04/24,Food,Food,Salmon,4,15000,60000,0,56000,4000
10/04/24,Food,Food,Macaroni,1,5000,5000,0,4000,1000
10/04/24,Food,Food,Fish & Chips,3,30000,90000,0,81000,9000
10/04/24,Food,Food,Burger,2,15000,30000,0,28000,2000
10/04/24,Food,Food,Hotdog,3,10000,30000,0,27000,3000
10/04/24,Food,Food,Pasta,1,18000,18000,0,16000,2000
10/04/24,Food,Snack,Chips,2,5000,10000,0,8000,2000
10/04/24,Food,Snack,Popcorn,1,7000,7000,0,6500,500
10/04/24,Food,Snack,Almonds,1,8000,8000,0,7000,1000
10/04/24,Food,Beverages,Lemon Tea,5,4000,20000,0,15000,5000
10/04/24,Food,Beverages,Ocha,2,4000,8000,0,7000,1000
10/04/24,Food,Beverages,Lychee Tea,3,6000,18000,0,15000,3000
10/04/24,Food,Beverages,Oolong Tea,1,6000,6000,0,5000,1000
10/04/24,Food,Beverages,Soda,3,5000,15000,0,12000,3000
10/05/24,Food,Food,Takoyaki,3,10000,30000,0,24000,6000
10/05/24,Food,Food,Steak,4,60000,240000,0,220000,20000
10/05/24,Food,Food,Rendang,1,10000,10000,0,8000,2000
10/05/24,Food,Food,Fried Chicken,10,3000,30000,0,20000,10000
10/05/24,Food,Food,Noodles,8,6000,48000,0,40000,8000
10/05/24,Food,Food,Salmon,4,15000,60000,0,56000,4000
10/05/24,Food,Food,Macaroni,1,5000,5000,0,4000,1000
10/05/24,Food,Food,Fish & Chips,3,30000,90000,0,81000,9000
10/05/24,Food,Food,Burger,2,15000,30000,0,28000,2000
10/05/24,Food,Food,Hotdog,3,10000,30000,0,27000,3000
10/05/24,Food,Food,Pasta,1,18000,18000,0,16000,2000
10/05/24,Food,Snack,Chips,2,5000,10000,0,8000,2000
10/05/24,Food,Snack,Popcorn,1,7000,7000,0,6500,500
10/05/24,Food,Snack,Almonds,1,8000,8000,0,7000,1000
10/05/24,Food,Beverages,Lemon Tea,5,4000,20000,0,15000,5000
10/05/24,Food,Beverages,Ocha,2,4000,8000,0,7000,1000
10/05/24,Food,Beverages,Lychee Tea,3,6000,18000,0,15000,3000
10/05/24,Food,Beverages,Oolong Tea,1,6000,6000,0,5000,1000
10/05/24,Food,Beverages,Soda,3,5000,15000,0,12000,3000
10/06/24,Food,Food,Takoyaki,3,10000,30000,0,24000,6000
10/06/24,Food,Food,Steak,4,60000,240000,0,220000,20000
10/06/24,Food,Food,Rendang,1,10000,10000,0,8000,2000
10/06/24,Food,Food,Fried Chicken,10,3000,30000,0,20000,10000
10/06/24,Food,Food,Noodles,8,6000,48000,0,40000,8000
10/06/24,Food,Food,Salmon,4,15000,60000,0,56000,4000
10/06/24,Food,Food,Macaroni,1,5000,5000,0,4000,1000
10/06/24,Food,Food,Fish & Chips,3,30000,90000,0,81000,9000
10/06/24,Food,Food,Burger,2,15000,30000,0,28000,2000
10/06/24,Food,Food,Hotdog,3,10000,30000,0,27000,3000
10/06/24,Food,Food,Pasta,1,18000,18000,0,16000,2000
10/06/24,Food,Snack,Chips,2,5000,10000,0,8000,2000
10/06/24,Food,Snack,Popcorn,1,7000,7000,0,6500,500
10/06/24,Food,Snack,Almonds,1,8000,8000,0,7000,1000
10/06/24,Food,Beverages,Lemon Tea,5,4000,20000,0,15000,5000
10/06/24,Food,Beverages,Ocha,2,4000,8000,0,7000,1000
10/06/24,Food,Beverages,Lychee Tea,3,6000,18000,0,15000,3000
10/06/24,Food,Beverages,Oolong Tea,1,6000,6000,0,5000,1000
10/06/24,Food,Beverages,Soda,3,5000,15000,0,12000,3000
10/07/24,Food,Food,Takoyaki,3,10000,30000,0,24000,6000
10/07/24,Food,Food,Steak,4,60000,240000,0,220000,20000
10/07/24,Food,Food,Rendang,1,10000,10000,0,8000,2000
10/07/24,Food,Food,Fried Chicken,10,3000,30000,0,20000,10000
10/07/24,Food,Food,Noodles,8,6000,48000,0,40000,8000
10/07/24,Food,Food,Salmon,4,15000,60000,0,56000,4000
10/07/24,Food,Food,Macaroni,1,5000,5000,0,4000,1000
10/07/24,Food,Food,Fish & Chips,3,30000,90000,0,81000,9000
10/07/24,Food,Food,Burger,2,15000,30000,0,28000,2000
10/07/24,Food,Food,Hotdog,3,10000,30000,0,27000,3000
10/07/24,Food,Food,Pasta,1,18000,18000,0,16000,2000
10/07/24,Food,Snack,Chips,2,5000,10000,0,8000,2000
10/07/24,Food,Snack,Popcorn,1,7000,7000,0,6500,500
10/07/24,Food,Snack,Almonds,1,8000,8000,0,7000,1000
10/07/24,Food,Beverages,Lemon Tea,5,4000,20000,0,15000,5000
10/07/24,Food,Beverages,Ocha,2,4000,8000,0,7000,1000
10/07/24,Food,Beverages,Lychee Tea,3,6000,18000,0,15000,3000
10/07/24,Food,Beverages,Oolong Tea,1,6000,6000,0,5000,1000
10/07/24,Food,Beverages,Soda,3,5000,15000,0,12000,3000
10/08/24,Food,Food,Takoyaki,3,10000,30000,0,24000,6000
10/08/24,Food,Food,Steak,4,60000,240000,0,220000,20000
10/08/24,Food,Food,Rendang,1,10000,10000,0,8000,2000
10/08/24,Food,Food,Fried Chicken,10,3000,30000,0,20000,10000
10/08/24,Food,Food,Noodles,8,6000,48000,0,40000,8000
10/08/24,Food,Food,Salmon,4,15000,60000,0,56000,4000
10/08/24,Food,Food,Macaroni,1,5000,5000,0,4000,1000
10/08/24,Food,Food,Fish & Chips,3,30000,90000,0,81000,9000
10/08/24,Food,Food,Burger,2,15000,30000,0,28000,2000
10/08/24,Food,Food,Hotdog,3,10000,30000,0,27000,3000
10/08/24,Food,Food,Pasta,1,18000,18000,0,16000,2000
10/08/24,Food,Snack,Chips,2,5000,10000,0,8000,2000
10/08/24,Food,Snack,Popcorn,1,7000,7000,0,6500,500
10/08/24,Food,Snack,Almonds,1,8000,8000,0,7000,1000
10/08/24,Food,Beverages,Lemon Tea,5,4000,20000,0,15000,5000
10/08/24,Food,Beverages,Ocha,2,4000,8000,0,7000,1000
10/08/24,Food,Beverages,Lychee Tea,3,6000,18000,0,15000,3000
10/08/24,Food,Beverages,Oolong Tea,1,6000,6000,0,5000,1000
10/08/24,Food,Beverages,Soda,3,5000,15000,0,12000,3000
10/09/24,Food,Food,Takoyaki,3,10000,30000,0,24000,6000
10/09/24,Food,Food,Steak,4,60000,240000,0,220000,20000
10/09/24,Food,Food,Rendang,1,10000,10000,0,8000,2000
10/09/24,Food,Food,Fried Chicken,10,3000,30000,0,20000,10000
10/09/24,Food,Food,Noodles,8,6000,48000,0,40000,8000
10/09/24,Food,Food,Salmon,4,15000,60000,0,56000,4000
10/09/24,Food,Food,Macaroni,1,5000,5000,0,4000,1000
10/09/24,Food,Food,Fish & Chips,3,30000,90000,0,81000,9000
10/09/24,Food,Food,Burger,2,15000,30000,0,28000,2000
10/09/24,Food,Food,Hotdog,3,10000,30000,0,27000,3000
10/09/24,Food,Food,Pasta,1,18000,18000,0,16000,2000
10/09/24,Food,Snack,Chips,2,5000,10000,0,8000,2000
10/09/24,Food,Snack,Popcorn,1,7000,7000,0,6500,500
10/09/24,Food,Snack,Almonds,1,8000,8000,0,7000,1000
10/09/24,Food,Beverages,Lemon Tea,5,4000,20000,0,15000,5000
10/09/24,Food,Beverages,Ocha,2,4000,8000,0,7000,1000
10/09/24,Food,Beverages,Lychee Tea,3,6000,18000,0,15000,3000
10/09/24,Food,Beverages,Oolong Tea,1,6000,6000,0,5000,1000
10/09/24,Food,Beverages,Soda,3,5000,15000,0,12000,3000
10/10/24,Food,Food,Takoyaki,3,10000,30000,0,24000,6000
10/10/24,Food,Food,Steak,4,60000,240000,0,220000,20000
10/10/24,Food,Food,Rendang,1,10000,10000,0,8000,2000
10/10/24,Food,Food,Fried Chicken,10,3000,30000,0,20000,10000
10/10/24,Food,Food,Noodles,8,6000,48000,0,40000,8000
10/10/24,Food,Food,Salmon,4,15000,60000,0,56000,4000
10/10/24,Food,Food,Macaroni,1,5000,5000,0,4000,1000
10/10/24,Food,Food,Fish & Chips,3,30000,90000,0,81000,9000
10/10/24,Food,Food,Burger,2,15000,30000,0,28000,2000
10/10/24,Food,Food,Hotdog,3,10000,30000,0,27000,3000
10/10/24,Food,Food,Pasta,1,18000,18000,0,16000,2000
10/10/24,Food,Snack,Chips,2,5000,10000,0,8000,2000
10/10/24,Food,Snack,Popcorn,1,7000,7000,0,6500,500
10/10/24,Food,Snack,Almonds,1,8000,8000,0,7000,1000
10/10/24,Food,Beverages,Lemon Tea,5,4000,20000,0,15000,5000
10/10/24,Food,Beverages,Ocha,2,4000,8000,0,7000,1000
10/10/24,Food,Beverages,Lychee Tea,3,6000,18000,0,15000,3000
10/10/24,Food,Beverages,Oolong Tea,1,6000,6000,0,5000,1000
10/10/24,Food,Beverages,Soda,3,5000,15000,0,12000,3000
10/11/24,Food,Food,Takoyaki,3,10000,30000,0,24000,6000
10/11/24,Food,Food,Steak,4,60000,240000,0,220000,20000
10/11/24,Food,Food,Rendang,1,10000,10000,0,8000,2000
10/11/24,Food,Food,Fried Chicken,10,3000,30000,0,20000,10000
10/11/24,Food,Food,Noodles,8,6000,48000,0,40000,8000
10/11/24,Food,Food,Salmon,4,15000,60000,0,56000,4000
10/11/24,Food,Food,Macaroni,1,5000,5000,0,4000,1000
10/11/24,Food,Food,Fish & Chips,3,30000,90000,0,81000,9000
10/11/24,Food,Food,Burger,2,15000,30000,0,28000,2000
10/11/24,Food,Food,Hotdog,3,10000,30000,0,27000,3000
10/11/24,Food,Food,Pasta,1,18000,18000,0,16000,2000
10/11/24,Food,Snack,Chips,2,5000,10000,0,8000,2000
10/11/24,Food,Snack,Popcorn,1,7000,7000,0,6500,500
10/11/24,Food,Snack,Almonds,1,8000,8000,0,7000,1000
10/11/24,Food,Beverages,Lemon Tea,5,4000,20000,0,15000,5000
10/11/24,Food,Beverages,Ocha,2,4000,8000,0,7000,1000
10/11/24,Food,Beverages,Lychee Tea,3,6000,18000,0,15000,3000
10/11/24,Food,Beverages,Oolong Tea,1,6000,6000,0,5000,1000
10/11/24,Food,Beverages,Soda,3,5000,15000,0,12000,3000
10/12/24,Food,Food,Takoyaki,3,10000,30000,0,24000,6000
10/12/24,Food,Food,Steak,4,60000,240000,0,220000,20000
10/12/24,Food,Food,Rendang,1,10000,10000,0,8000,2000
10/12/24,Food,Food,Fried Chicken,10,3000,30000,0,20000,10000
10/12/24,Food,Food,Noodles,8,6000,48000,0,40000,8000
10/12/24,Food,Food,Salmon,4,15000,60000,0,56000,4000
10/12/24,Food,Food,Macaroni,1,5000,5000,0,4000,1000
10/12/24,Food,Food,Fish & Chips,3,30000,90000,0,81000,9000
10/12/24,Food,Food,Burger,2,15000,30000,0,28000,2000
10/12/24,Food,Food,Hotdog,3,10000,30000,0,27000,3000
10/12/24,Food,Food,Pasta,1,18000,18000,0,16000,2000
10/12/24,Food,Snack,Chips,2,5000,10000,0,8000,2000
10/12/24,Food,Snack,Popcorn,1,7000,7000,0,6500,500
10/12/24,Food,Snack,Almonds,1,8000,8000,0,7000,1000
10/12/24,Food,Beverages,Lemon Tea,5,4000,20000,0,15000,5000
10/12/24,Food,Beverages,Ocha,2,4000,8000,0,7000,1000
10/12/24,Food,Beverages,Lychee Tea,3,6000,18000,0,15000,3000
10/12/24,Food,Beverages,Oolong Tea,1,6000,6000,0,5000,1000
10/12/24,Food,Beverages,Soda,3,5000,15000,0,12000,3000
10/13/24,Food,Food,Takoyaki,3,10000,30000,0,24000,6000
10/13/24,Food,Food,Steak,4,60000,240000,0,220000,20000
10/13/24,Food,Food,Rendang,1,10000,10000,0,8000,2000
10/13/24,Food,Food,Fried Chicken,10,3000,30000,0,20000,10000
10/13/24,Food,Food,Noodles,8,6000,48000,0,40000,8000
10/13/24,Food,Food,Salmon,4,15000,60000,0,56000,4000
10/13/24,Food,Food,Macaroni,1,5000,5000,0,4000,1000
10/13/24,Food,Food,Fish & Chips,3,30000,90000,0,81000,9000
10/13/24,Food,Food,Burger,2,15000,30000,0,28000,2000
10/13/24,Food,Food,Hotdog,3,10000,30000,0,27000,3000
10/13/24,Food,Food,Pasta,1,18000,18000,0,16000,2000
10/13/24,Food,Snack,Chips,2,5000,10000,0,8000,2000
10/13/24,Food,Snack,Popcorn,1,7000,7000,0,6500,500
10/13/24,Food,Snack,Almonds,1,8000,8000,0,7000,1000
10/13/24,Food,Beverages,Lemon Tea,5,4000,20000,0,15000,5000
10/13/24,Food,Beverages,Ocha,2,4000,8000,0,7000,1000
10/13/24,Food,Beverages,Lychee Tea,3,6000,18000,0,15000,3000
10/13/24,Food,Beverages,Oolong Tea,1,6000,6000,0,5000,1000
10/13/24,Food,Beverages,Soda,3,5000,15000,0,12000,3000
10/14/24,Food,Food,Takoyaki,3,10000,30000,0,24000,6000
10/14/24,Food,Food,Steak,4,60000,240000,0,220000,20000
10/14/24,Food,Food,Rendang,1,10000,10000,0,8000,2000
10/14/24,Food,Food,Fried Chicken,10,3000,30000,0,20000,10000
10/14/24,Food,Food,Noodles,8,6000,48000,0,40000,8000
10/14/24,Food,Food,Salmon,4,15000,60000,0,56000,4000
10/14/24,Food,Food,Macaroni,1,5000,5000,0,4000,1000
10/14/24,Food,Food,Fish & Chips,3,30000,90000,0,81000,9000
10/14/24,Food,Food,Burger,2,15000,30000,0,28000,2000
10/14/24,Food,Food,Hotdog,3,10000,30000,0,27000,3000
10/14/24,Food,Food,Pasta,1,18000,18000,0,16000,2000
10/14/24,Food,Snack,Chips,2,5000,10000,0,8000,2000
10/14/24,Food,Snack,Popcorn,1,7000,7000,0,6500,500
10/14/24,Food,Snack,Almonds,1,8000,8000,0,7000,1000
10/14/24,Food,Beverages,Lemon Tea,5,4000,20000,0,15000,5000
10/14/24,Food,Beverages,Ocha,2,4000,8000,0,7000,1000
10/14/24,Food,Beverages,Lychee Tea,3,6000,18000,0,15000,3000
10/14/24,Food,Beverages,Oolong Tea,1,6000,6000,0,5000,1000
10/14/24,Food,Beverages,Soda,3,5000,15000,0,12000,3000
10/15/24,Food,Food,Takoyaki,3,10000,30000,0,24000,6000
10/15/24,Food,Food,Steak,4,60000,240000,0,220000,20000
10/15/24,Food,Food,Rendang,1,10000,10000,0,8000,2000
10/15/24,Food,Food,Fried Chicken,10,3000,30000,0,20000,10000
10/15/24,Food,Food,Noodles,8,6000,48000,0,40000,8000
10/15/24,Food,Food,Salmon,4,15000,60000,0,56000,4000
10/15/24,Food,Food,Macaroni,1,5000,5000,0,4000,1000
10/15/24,Food,Food,Fish & Chips,3,30000,90000,0,81000,9000
10/15/24,Food,Food,Burger,2,15000,30000,0,28000,2000
10/15/24,Food,Food,Hotdog,3,10000,30000,0,27000,3000
10/15/24,Food,Food,Pasta,1,18000,18000,0,16000,2000
10/15/24,Food,Snack,Chips,2,5000,10000,0,8000,2000
10/15/24,Food,Snack,Popcorn,1,7000,7000,0,6500,500
10/15/24,Food,Snack,Almonds,1,8000,8000,0,7000,1000
10/15/24,Food,Beverages,Lemon Tea,5,4000,20000,0,15000,5000
10/15/24,Food,Beverages,Ocha,2,4000,8000,0,7000,1000
10/15/24,Food,Beverages,Lychee Tea,3,6000,18000,0,15000,3000
10/15/24,Food,Beverages,Oolong Tea,1,6000,6000,0,5000,1000
10/15/24,Food,Beverages,Soda,3,5000,15000,0,12000,3000
10/16/24,Food,Food,Takoyaki,3,10000,30000,0,24000,6000
10/16/24,Food,Food,Steak,4,60000,240000,0,220000,20000
10/16/24,Food,Food,Rendang,1,10000,10000,0,8000,2000
10/16/24,Food,Food,Fried Chicken,10,3000,30000,0,20000,10000
10/16/24,Food,Food,Noodles,8,6000,48000,0,40000,8000
10/16/24,Food,Food,Salmon,4,15000,60000,0,56000,4000
10/16/24,Food,Food,Macaroni,1,5000,5000,0,4000,1000
10/16/24,Food,Food,Fish & Chips,3,30000,90000,0,81000,9000
10/16/24,Food,Food,Burger,2,15000,30000,0,28000,2000
10/16/24,Food,Food,Hotdog,3,10000,30000,0,27000,3000
10/16/24,Food,Food,Pasta,1,18000,18000,0,16000,2000
10/16/24,Food,Snack,Chips,2,5000,10000,0,8000,2000
10/16/24,Food,Snack,Popcorn,1,7000,7000,0,6500,500
10/16/24,Food,Snack,Almonds,1,8000,8000,0,7000,1000
10/16/24,Food,Beverages,Lemon Tea,5,4000,20000,0,15000,5000
10/16/24,Food,Beverages,Ocha,2,4000,8000,0,7000,1000
10/16/24,Food,Beverages,Lychee Tea,3,6000,18000,0,15000,3000
10/16/24,Food,Beverages,Oolong Tea,1,6000,6000,0,5000,1000
10/16/24,Food,Beverages,Soda,3,5000,15000,0,12000,3000
10/17/24,Food,Food,Takoyaki,3,10000,30000,0,24000,6000
10/17/24,Food,Food,Steak,4,60000,240000,0,220000,20000
10/17/24,Food,Food,Rendang,1,10000,10000,0,8000,2000
10/17/24,Food,Food,Fried Chicken,10,3000,30000,0,20000,10000
10/17/24,Food,Food,Noodles,8,6000,48000,0,40000,8000
10/17/24,Food,Food,Salmon,4,15000,60000,0,56000,4000
10/17/24,Food,Food,Macaroni,1,5000,5000,0,4000,1000
10/17/24,Food,Food,Fish & Chips,3,30000,90000,0,81000,9000
10/17/24,Food,Food,Burger,2,15000,30000,0,28000,2000
10/17/24,Food,Food,Hotdog,3,10000,30000,0,27000,3000
10/17/24,Food,Food,Pasta,1,18000,18000,0,16000,2000
10/17/24,Food,Snack,Chips,2,5000,10000,0,8000,2000
10/17/24,Food,Snack,Popcorn,1,7000,7000,0,6500,500
10/17/24,Food,Snack,Almonds,1,8000,8000,0,7000,1000
10/17/24,Food,Beverages,Lemon Tea,5,4000,20000,0,15000,5000
10/17/24,Food,Beverages,Ocha,2,4000,8000,0,7000,1000
10/17/24,Food,Beverages,Lychee Tea,3,6000,18000,0,15000,3000
10/17/24,Food,Beverages,Oolong Tea,1,6000,6000,0,5000,1000
10/17/24,Food,Beverages,Soda,3,5000,15000,0,12000,3000
10/18/24,Food,Food,Takoyaki,3,10000,30000,0,24000,6000
10/18/24,Food,Food,Steak,4,60000,240000,0,220000,20000
10/18/24,Food,Food,Rendang,1,10000,10000,0,8000,2000
10/18/24,Food,Food,Fried Chicken,10,3000,30000,0,20000,10000
10/18/24,Food,Food,Noodles,8,6000,48000,0,40000,8000
10/18/24,Food,Food,Salmon,4,15000,60000,0,56000,4000
10/18/24,Food,Food,Macaroni,1,5000,5000,0,4000,1000
10/18/24,Food,Food,Fish & Chips,3,30000,90000,0,81000,9000
10/18/24,Food,Food,Burger,2,15000,30000,0,28000,2000
10/18/24,Food,Food,Hotdog,3,10000,30000,0,27000,3000
10/18/24,Food,Food,Pasta,1,18000,18000,0,16000,2000
10/18/24,Food,Snack,Chips,2,5000,10000,0,8000,2000
10/18/24,Food,Snack,Popcorn,1,7000,7000,0,6500,500
10/18/24,Food,Snack,Almonds,1,8000,8000,0,7000,1000
10/18/24,Food,Beverages,Lemon Tea,5,4000,20000,0,15000,5000
10/18/24,Food,Beverages,Ocha,2,4000,8000,0,7000,1000
10/18/24,Food,Beverages,Lychee Tea,3,6000,18000,0,15000,3000
10/18/24,Food,Beverages,Oolong Tea,1,6000,6000,0,5000,1000
10/18/24,Food,Beverages,Soda,3,5000,15000,0,12000,3000
10/19/24,Food,Food,Takoyaki,3,10000,30000,0,24000,6000
10/19/24,Food,Food,Steak,4,60000,240000,0,220000,20000
10/19/24,Food,Food,Rendang,1,10000,10000,0,8000,2000
10/19/24,Food,Food,Fried Chicken,10,3000,30000,0,20000,10000
10/19/24,Food,Food,Noodles,8,6000,48000,0,40000,8000
10/19/24,Food,Food,Salmon,4,15000,60000,0,56000,4000
10/19/24,Food,Food,Macaroni,1,5000,5000,0,4000,1000
10/19/24,Food,Food,Fish & Chips,3,30000,90000,0,81000,9000
10/19/24,Food,Food,Burger,2,15000,30000,0,28000,2000
10/19/24,Food,Food,Hotdog,3,10000,30000,0,27000,3000
10/19/24,Food,Food,Pasta,1,18000,18000,0,16000,2000
10/19/24,Food,Snack,Chips,2,5000,10000,0,8000,2000
10/19/24,Food,Snack,Popcorn,1,7000,7000,0,6500,500
10/19/24,Food,Snack,Almonds,1,8000,8000,0,7000,1000
10/19/24,Food,Beverages,Lemon Tea,5,4000,20000,0,15000,5000
10/19/24,Food,Beverages,Ocha,2,4000,8000,0,7000,1000
10/19/24,Food,Beverages,Lychee Tea,3,6000,18000,0,15000,3000
10/19/24,Food,Beverages,Oolong Tea,1,6000,6000,0,5000,1000
10/19/24,Food,Beverages,Soda,3,5000,15000,0,12000,3000
10/20/24,Food,Food,Takoyaki,3,10000,30000,0,24000,6000
10/20/24,Food,Food,Steak,4,60000,240000,0,220000,20000
10/20/24,Food,Food,Rendang,1,10000,10000,0,8000,2000
10/20/24,Food,Food,Fried Chicken,10,3000,30000,0,20000,10000
10/20/24,Food,Food,Noodles,8,6000,48000,0,40000,8000
10/20/24,Food,Food,Salmon,4,15000,60000,0,56000,4000
10/20/24,Food,Food,Macaroni,1,5000,5000,0,4000,1000
10/20/24,Food,Food,Fish & Chips,3,30000,90000,0,81000,9000
10/20/24,Food,Food,Burger,2,15000,30000,0,28000,2000
10/20/24,Food,Food,Hotdog,3,10000,30000,0,27000,3000
10/20/24,Food,Food,Pasta,1,18000,18000,0,16000,2000
10/20/24,Food,Snack,Chips,2,5000,10000,0,8000,2000
10/20/24,Food,Snack,Popcorn,1,7000,7000,0,6500,500
10/20/24,Food,Snack,Almonds,1,8000,8000,0,7000,1000
10/20/24,Food,Beverages,Lemon Tea,5,4000,20000,0,15000,5000
10/20/24,Food,Beverages,Ocha,2,4000,8000,0,7000,1000
10/20/24,Food,Beverages,Lychee Tea,3,6000,18000,0,15000,3000
10/20/24,Food,Beverages,Oolong Tea,1,6000,6000,0,5000,1000
10/20/24,Food,Beverages,Soda,3,5000,15000,0,12000,3000
10/21/24,Food,Food,Takoyaki,3,10000,30000,0,24000,6000
10/21/24,Food,Food,Steak,4,60000,240000,0,220000,20000
10/21/24,Food,Food,Rendang,1,10000,10000,0,8000,2000
10/21/24,Food,Food,Fried Chicken,10,3000,30000,0,20000,10000
10/21/24,Food,Food,Noodles,8,6000,48000,0,40000,8000
10/21/24,Food,Food,Salmon,4,15000,60000,0,56000,4000
10/21/24,Food,Food,Macaroni,1,5000,5000,0,4000,1000
10/21/24,Food,Food,Fish & Chips,3,30000,90000,0,81000,9000
10/21/24,Food,Food,Burger,2,15000,30000,0,28000,2000
10/21/24,Food,Food,Hotdog,3,10000,30000,0,27000,3000
10/21/24,Food,Food,Pasta,1,18000,18000,0,16000,2000
10/21/24,Food,Snack,Chips,2,5000,10000,0,8000,2000
10/21/24,Food,Snack,Popcorn,1,7000,7000,0,6500,500
10/21/24,Food,Snack,Almonds,1,8000,8000,0,7000,1000
10/21/24,Food,Beverages,Lemon Tea,5,4000,20000,0,15000,5000
10/21/24,Food,Beverages,Ocha,2,4000,8000,0,7000,1000
10/21/24,Food,Beverages,Lychee Tea,3,6000,18000,0,15000,3000
10/21/24,Food,Beverages,Oolong Tea,1,6000,6000,0,5000,1000
10/21/24,Food,Beverages,Soda,3,5000,15000,0,12000,3000
10/22/24,Food,Food,Takoyaki,3,10000,30000,0,24000,6000
10/22/24,Food,Food,Steak,4,60000,240000,0,220000,20000
10/22/24,Food,Food,Rendang,1,10000,10000,0,8000,2000
10/22/24,Food,Food,Fried Chicken,10,3000,30000,0,20000,10000
10/22/24,Food,Food,Noodles,8,6000,48000,0,40000,8000
10/22/24,Food,Food,Salmon,4,15000,60000,0,56000,4000
10/22/24,Food,Food,Macaroni,1,5000,5000,0,4000,1000
10/22/24,Food,Food,Fish & Chips,3,30000,90000,0,81000,9000
10/22/24,Food,Food,Burger,2,15000,30000,0,28000,2000
10/22/24,Food,Food,Hotdog,3,10000,30000,0,27000,3000
10/22/24,Food,Food,Pasta,1,18000,18000,0,16000,2000
10/22/24,Food,Snack,Chips,2,5000,10000,0,8000,2000
10/22/24,Food,Snack,Popcorn,1,7000,7000,0,6500,500
10/22/24,Food,Snack,Almonds,1,8000,8000,0,7000,1000
10/22/24,Food,Beverages,Lemon Tea,5,4000,20000,0,15000,5000
10/22/24,Food,Beverages,Ocha,2,4000,8000,0,7000,1000
10/22/24,Food,Beverages,Lychee Tea,3,6000,18000,0,15000,3000
10/22/24,Food,Beverages,Oolong Tea,1,6000,6000,0,5000,1000
10/22/24,Food,Beverages,Soda,3,5000,15000,0,12000,3000
10/23/24,Food,Food,Takoyaki,3,10000,30000,0,24000,6000
10/23/24,Food,Food,Steak,4,60000,240000,0,220000,20000
10/23/24,Food,Food,Rendang,1,10000,10000,0,8000,2000
10/23/24,Food,Food,Fried Chicken,10,3000,30000,0,20000,10000
10/23/24,Food,Food,Noodles,8,6000,48000,0,40000,8000
10/23/24,Food,Food,Salmon,4,15000,60000,0,56000,4000
10/23/24,Food,Food,Macaroni,1,5000,5000,0,4000,1000
10/23/24,Food,Food,Fish & Chips,3,30000,90000,0,81000,9000
10/23/24,Food,Food,Burger,2,15000,30000,0,28000,2000
10/23/24,Food,Food,Hotdog,3,10000,30000,0,27000,3000
10/23/24,Food,Food,Pasta,1,18000,18000,0,16000,2000
10/23/24,Food,Snack,Chips,2,5000,10000,0,8000,2000
10/23/24,Food,Snack,Popcorn,1,7000,7000,0,6500,500
10/23/24,Food,Snack,Almonds,1,8000,8000,0,7000,1000
10/23/24,Food,Beverages,Lemon Tea,5,4000,20000,0,15000,5000
10/23/24,Food,Beverages,Ocha,2,4000,8000,0,7000,1000
10/23/24,Food,Beverages,Lychee Tea,3,6000,18000,0,15000,3000
10/23/24,Food,Beverages,Oolong Tea,1,6000,6000,0,5000,1000
10/23/24,Food,Beverages,Soda,3,5000,15000,0,12000,3000
10/24/24,Food,Food,Takoyaki,3,10000,30000,0,24000,6000
10/24/24,Food,Food,Steak,4,60000,240000,0,220000,20000
10/24/24,Food,Food,Rendang,1,10000,10000,0,8000,2000
10/24/24,Food,Food,Fried Chicken,10,3000,30000,0,20000,10000
10/24/24,Food,Food,Noodles,8,6000,48000,0,40000,8000
10/24/24,Food,Food,Salmon,4,15000,60000,0,56000,4000
10/24/24,Food,Food,Macaroni,1,5000,5000,0,4000,1000
10/24/24,Food,Food,Fish & Chips,3,30000,90000,0,81000,9000
10/24/24,Food,Food,Burger,2,15000,30000,0,28000,2000
10/24/24,Food,Food,Hotdog,3,10000,30000,0,27000,3000
10/24/24,Food,Food,Pasta,1,18000,18000,0,16000,2000
10/24/24,Food,Snack,Chips,2,5000,10000,0,8000,2000
10/24/24,Food,Snack,Popcorn,1,7000,7000,0,6500,500
10/24/24,Food,Snack,Almonds,1,8000,8000,0,7000,1000
10/24/24,Food,Beverages,Lemon Tea,5,4000,20000,0,15000,5000
10/24/24,Food,Beverages,Ocha,2,4000,8000,0,7000,1000
10/24/24,Food,Beverages,Lychee Tea,3,6000,18000,0,15000,3000
10/24/24,Food,Beverages,Oolong Tea,1,6000,6000,0,5000,1000
10/24/24,Food,Beverages,Soda,3,5000,15000,0,12000,3000
10/25/24,Food,Food,Takoyaki,3,10000,30000,0,24000,6000
10/25/24,Food,Food,Steak,4,60000,240000,0,220000,20000
10/25/24,Food,Food,Rendang,1,10000,10000,0,8000,2000
10/25/24,Food,Food,Fried Chicken,10,3000,30000,0,20000,10000
10/25/24,Food,Food,Noodles,8,6000,48000,0,40000,8000
10/25/24,Food,Food,Salmon,4,15000,60000,0,56000,4000
10/25/24,Food,Food,Macaroni,1,5000,5000,0,4000,1000
10/25/24,Food,Food,Fish & Chips,3,30000,90000,0,81000,9000
10/25/24,Food,Food,Burger,2,15000,30000,0,28000,2000
10/25/24,Food,Food,Hotdog,3,10000,30000,0,27000,3000
10/25/24,Food,Food,Pasta,1,18000,18000,0,16000,2000
10/25/24,Food,Snack,Chips,2,5000,10000,0,8000,2000
10/25/24,Food,Snack,Popcorn,1,7000,7000,0,6500,500
10/25/24,Food,Snack,Almonds,1,8000,8000,0,7000,1000
10/25/24,Food,Beverages,Lemon Tea,5,4000,20000,0,15000,5000
10/25/24,Food,Beverages,Ocha,2,4000,8000,0,7000,1000
10/25/24,Food,Beverages,Lychee Tea,3,6000,18000,0,15000,3000
10/25/24,Food,Beverages,Oolong Tea,1,6000,6000,0,5000,1000
10/25/24,Food,Beverages,Soda,3,5000,15000,0,12000,3000
10/26/24,Food,Food,Takoyaki,3,10000,30000,0,24000,6000
10/26/24,Food,Food,Steak,4,60000,240000,0,220000,20000
10/26/24,Food,Food,Rendang,1,10000,10000,0,8000,2000
10/26/24,Food,Food,Fried Chicken,10,3000,30000,0,20000,10000
10/26/24,Food,Food,Noodles,8,6000,48000,0,40000,8000
10/26/24,Food,Food,Salmon,4,15000,60000,0,56000,4000
10/26/24,Food,Food,Macaroni,1,5000,5000,0,4000,1000
10/26/24,Food,Food,Fish & Chips,3,30000,90000,0,81000,9000
10/26/24,Food,Food,Burger,2,15000,30000,0,28000,2000
10/26/24,Food,Food,Hotdog,3,10000,30000,0,27000,3000
10/26/24,Food,Food,Pasta,1,18000,18000,0,16000,2000
10/26/24,Food,Snack,Chips,2,5000,10000,0,8000,2000
10/26/24,Food,Snack,Popcorn,1,7000,7000,0,6500,500
10/26/24,Food,Snack,Almonds,1,8000,8000,0,7000,1000
10/26/24,Food,Beverages,Lemon Tea,5,4000,20000,0,15000,5000
10/26/24,Food,Beverages,Ocha,2,4000,8000,0,7000,1000
10/26/24,Food,Beverages,Lychee Tea,3,6000,18000,0,15000,3000
10/26/24,Food,Beverages,Oolong Tea,1,6000,6000,0,5000,1000
10/26/24,Food,Beverages,Soda,3,5000,15000,0,12000,3000
10/27/24,Food,Food,Takoyaki,3,10000,30000,0,24000,6000
10/27/24,Food,Food,Steak,4,60000,240000,0,220000,20000
10/27/24,Food,Food,Rendang,1,10000,10000,0,8000,2000
10/27/24,Food,Food,Fried Chicken,10,3000,30000,0,20000,10000
10/27/24,Food,Food,Noodles,8,6000,48000,0,40000,8000
10/27/24,Food,Food,Salmon,4,15000,60000,0,56000,4000
10/27/24,Food,Food,Macaroni,1,5000,5000,0,4000,1000
10/27/24,Food,Food,Fish & Chips,3,30000,90000,0,81000,9000
10/27/24,Food,Food,Burger,2,15000,30000,0,28000,2000
10/27/24,Food,Food,Hotdog,3,10000,30000,0,27000,3000
10/27/24,Food,Food,Pasta,1,18000,18000,0,16000,2000
10/27/24,Food,Snack,Chips,2,5000,10000,0,8000,2000
10/27/24,Food,Snack,Popcorn,1,7000,7000,0,6500,500
10/27/24,Food,Snack,Almonds,1,8000,8000,0,7000,1000
10/27/24,Food,Beverages,Lemon Tea,5,4000,20000,0,15000,5000
10/27/24,Food,Beverages,Ocha,2,4000,8000,0,7000,1000
10/27/24,Food,Beverages,Lychee Tea,3,6000,18000,0,15000,3000
10/27/24,Food,Beverages,Oolong Tea,1,6000,6000,0,5000,1000
10/27/24,Food,Beverages,Soda,3,5000,15000,0,12000,3000
10/28/24,Food,Food,Takoyaki,3,10000,30000,0,24000,6000
10/28/24,Food,Food,Steak,4,60000,240000,0,220000,20000
10/28/24,Food,Food,Rendang,1,10000,10000,0,8000,2000
10/28/24,Food,Food,Fried Chicken,10,3000,30000,0,20000,10000
10/28/24,Food,Food,Noodles,8,6000,48000,0,40000,8000
10/28/24,Food,Food,Salmon,4,15000,60000,0,56000,4000
10/28/24,Food,Food,Macaroni,1,5000,5000,0,4000,1000
10/28/24,Food,Food,Fish & Chips,3,30000,90000,0,81000,9000
10/28/24,Food,Food,Burger,2,15000,30000,0,28000,2000
10/28/24,Food,Food,Hotdog,3,10000,30000,0,27000,3000
10/28/24,Food,Food,Pasta,1,18000,18000,0,16000,2000
10/28/24,Food,Snack,Chips,2,5000,10000,0,8000,2000
10/28/24,Food,Snack,Popcorn,1,7000,7000,0,6500,500
10/28/24,Food,Snack,Almonds,1,8000,8000,0,7000,1000
10/28/24,Food,Beverages,Lemon Tea,5,4000,20000,0,15000,5000
10/28/24,Food,Beverages,Ocha,2,4000,8000,0,7000,1000
10/28/24,Food,Beverages,Lychee Tea,3,6000,18000,0,15000,3000
10/28/24,Food,Beverages,Oolong Tea,1,6000,6000,0,5000,1000
10/28/24,Food,Beverages,Soda,3,5000,15000,0,12000,3000
10/29/24,Food,Food,Takoyaki,3,10000,30000,0,24000,6000
10/29/24,Food,Food,Steak,4,60000,240000,0,220000,20000
10/29/24,Food,Food,Rendang,1,10000,10000,0,8000,2000
10/29/24,Food,Food,Fried Chicken,10,3000,30000,0,20000,10000
10/29/24,Food,Food,Noodles,8,6000,48000,0,40000,8000
10/29/24,Food,Food,Salmon,4,15000,60000,0,56000,4000
10/29/24,Food,Food,Macaroni,1,5000,5000,0,4000,1000
10/29/24,Food,Food,Fish & Chips,3,30000,90000,0,81000,9000
10/29/24,Food,Food,Burger,2,15000,30000,0,28000,2000
10/29/24,Food,Food,Hotdog,3,10000,30000,0,27000,3000
10/29/24,Food,Food,Pasta,1,18000,18000,0,16000,2000
10/29/24,Food,Snack,Chips,2,5000,10000,0,8000,2000
10/29/24,Food,Snack,Popcorn,1,7000,7000,0,6500,500
10/29/24,Food,Snack,Almonds,1,8000,8000,0,7000,1000
10/29/24,Food,Beverages,Lemon Tea,5,4000,20000,0,15000,5000
10/29/24,Food,Beverages,Ocha,2,4000,8000,0,7000,1000
10/29/24,Food,Beverages,Lychee Tea,3,6000,18000,0,15000,3000
10/29/24,Food,Beverages,Oolong Tea,1,6000,6000,0,5000,1000
10/29/24,Food,Beverages,Soda,3,5000,15000,0,12000,3000
10/30/24,Food,Food,Takoyaki,3,10000,30000,0,24000,6000
10/30/24,Food,Food,Steak,4,60000,240000,0,220000,20000
10/30/24,Food,Food,Rendang,1,10000,10000,0,8000,2000
10/30/24,Food,Food,Fried Chicken,10,3000,30000,0,20000,10000
10/30/24,Food,Food,Noodles,8,6000,48000,0,40000,8000
10/30/24,Food,Food,Salmon,4,15000,60000,0,56000,4000
10/30/24,Food,Food,Macaroni,1,5000,5000,0,4000,1000
10/30/24,Food,Food,Fish & Chips,3,30000,90000,0,81000,9000
10/30/24,Food,Food,Burger,2,15000,30000,0,28000,2000
10/30/24,Food,Food,Hotdog,3,10000,30000,0,27000,3000
10/30/24,Food,Food,Pasta,1,18000,18000,0,16000,2000
10/30/24,Food,Snack,Chips,2,5000,10000,0,8000,2000
10/30/24,Food,Snack,Popcorn,1,7000,7000,0,6500,500
10/30/24,Food,Snack,Almonds,1,8000,8000,0,7000,1000
10/30/24,Food,Beverages,Lemon Tea,5,4000,20000,0,15000,5000
10/30/24,Food,Beverages,Ocha,2,4000,8000,0,7000,1000
10/30/24,Food,Beverages,Lychee Tea,3,6000,18000,0,15000,3000
10/30/24,Food,Beverages,Oolong Tea,1,6000,6000,0,5000,1000
10/30/24,Food,Beverages,Soda,3,5000,15000,0,12000,3000
10/31/24,Food,Food,Takoyaki,3,10000,30000,0,24000,6000
10/31/24,Food,Food,Steak,4,60000,240000,0,220000,20000
10/31/24,Food,Food,Rendang,1,10000,10000,0,8000,2000
10/31/24,Food,Food,Fried Chicken,10,3000,30000,0,20000,10000
10/31/24,Food,Food,Noodles,8,6000,48000,0,40000,8000
10/31/24,Food,Food,Salmon,4,15000,60000,0,56000,4000
10/31/24,Food,Food,Macaroni,1,5000,5000,0,4000,1000
10/31/24,Food,Food,Fish & Chips,3,30000,90000,0,81000,9000
10/31/24,Food,Food,Burger,2,15000,30000,0,28000,2000
10/31/24,Food,Food,Hotdog,3,10000,30000,0,27000,3000
10/31/24,Food,Food,Pasta,1,18000,18000,0,16000,2000
10/31/24,Food,Snack,Chips,2,5000,10000,0,8000,2000
10/31/24,Food,Snack,Popcorn,1,7000,7000,0,6500,500
10/31/24,Food,Snack,Almonds,1,8000,8000,0,7000,1000
10/31/24,Food,Beverages,Lemon Tea,5,4000,20000,0,15000,5000
10/31/24,Food,Beverages,Ocha,2,4000,8000,0,7000,1000
10/31/24,Food,Beverages,Lychee Tea,3,6000,18000,0,15000,3000
10/31/24,Food,Beverages,Oolong Tea,1,6000,6000,0,5000,1000
10/31/24,Food,Beverages,Soda,3,5000,15000,0,12000,3000
11/01/24,Food,Food,Takoyaki,3,10000,30000,0,24000,6000
11/01/24,Food,Food,Steak,4,60000,240000,0,220000,20000
11/01/24,Food,Food,Rendang,1,10000,10000,0,8000,2000
11/01/24,Food,Food,Fried Chicken,10,3000,30000,0,20000,10000
11/01/24,Food,Food,Noodles,8,6000,48000,0,40000,8000
11/01/24,Food,Food,Salmon,4,15000,60000,0,56000,4000
11/01/24,Food,Food,Macaroni,1,5000,5000,0,4000,1000
11/01/24,Food,Food,Fish & Chips,3,30000,90000,0,81000,9000
11/01/24,Food,Food,Burger,2,15000,30000,0,28000,2000
11/01/24,Food,Food,Hotdog,3,10000,30000,0,27000,3000
11/01/24,Food,Food,Pasta,1,18000,18000,0,16000,2000
11/01/24,Food,Snack,Chips,2,5000,10000,0,8000,2000
11/01/24,Food,Snack,Popcorn,1,7000,7000,0,6500,500
11/01/24,Food,Snack,Almonds,1,8000,8000,0,7000,1000
11/01/24,Food,Beverages,Lemon Tea,5,4000,20000,0,15000,5000
11/01/24,Food,Beverages,Ocha,2,4000,8000,0,7000,1000
11/01/24,Food,Beverages,Lychee Tea,3,6000,18000,0,15000,3000
11/01/24,Food,Beverages,Oolong Tea,1,6000,6000,0,5000,1000
11/01/24,Food,Beverages,Soda,3,5000,15000,0,12000,3000
11/02/24,Food,Food,Takoyaki,3,10000,30000,0,24000,6000
11/02/24,Food,Food,Steak,4,60000,240000,0,220000,20000
11/02/24,Food,Food,Rendang,1,10000,10000,0,8000,2000
11/02/24,Food,Food,Fried Chicken,10,3000,30000,0,20000,10000
11/02/24,Food,Food,Noodles,8,6000,48000,0,40000,8000
11/02/24,Food,Food,Salmon,4,15000,60000,0,56000,4000
11/02/24,Food,Food,Macaroni,1,5000,5000,0,4000,1000
11/02/24,Food,Food,Fish & Chips,3,30000,90000,0,81000,9000
11/02/24,Food,Food,Burger,2,15000,30000,0,28000,2000
11/02/24,Food,Food,Hotdog,3,10000,30000,0,27000,3000
11/02/24,Food,Food,Pasta,1,18000,18000,0,16000,2000
11/02/24,Food,Snack,Chips,2,5000,10000,0,8000,2000
11/02/24,Food,Snack,Popcorn,1,7000,7000,0,6500,500
11/02/24,Food,Snack,Almonds,1,8000,8000,0,7000,1000
11/02/24,Food,Beverages,Lemon Tea,5,4000,20000,0,15000,5000
11/02/24,Food,Beverages,Ocha,2,4000,8000,0,7000,1000
11/02/24,Food,Beverages,Lychee Tea,3,6000,18000,0,15000,3000
11/02/24,Food,Beverages,Oolong Tea,1,6000,6000,0,5000,1000
11/02/24,Food,Beverages,Soda,3,5000,15000,0,12000,3000
11/03/24,Food,Food,Takoyaki,3,10000,30000,0,24000,6000
11/03/24,Food,Food,Steak,4,60000,240000,0,220000,20000
11/03/24,Food,Food,Rendang,1,10000,10000,0,8000,2000
11/03/24,Food,Food,Fried Chicken,10,3000,30000,0,20000,10000
11/03/24,Food,Food,Noodles,8,6000,48000,0,40000,8000
11/03/24,Food,Food,Salmon,4,15000,60000,0,56000,4000
11/03/24,Food,Food,Macaroni,1,5000,5000,0,4000,1000
11/03/24,Food,Food,Fish & Chips,3,30000,90000,0,81000,9000
11/03/24,Food,Food,Burger,2,15000,30000,0,28000,2000
11/03/24,Food,Food,Hotdog,3,10000,30000,0,27000,3000
11/03/24,Food,Food,Pasta,1,18000,18000,0,16000,2000
11/03/24,Food,Snack,Chips,2,5000,10000,0,8000,2000
11/03/24,Food,Snack,Popcorn,1,7000,7000,0,6500,500
11/03/24,Food,Snack,Almonds,1,8000,8000,0,7000,1000
11/03/24,Food,Beverages,Lemon Tea,5,4000,20000,0,15000,5000
11/03/24,Food,Beverages,Ocha,2,4000,8000,0,7000,1000
11/03/24,Food,Beverages,Lychee Tea,3,6000,18000,0,15000,3000
11/03/24,Food,Beverages,Oolong Tea,1,6000,6000,0,5000,1000
11/03/24,Food,Beverages,Soda,3,5000,15000,0,12000,3000
11/04/24,Food,Food,Takoyaki,3,10000,30000,0,24000,6000
11/04/24,Food,Food,Steak,4,60000,240000,0,220000,20000
11/04/24,Food,Food,Rendang,1,10000,10000,0,8000,2000
11/04/24,Food,Food,Fried Chicken,10,3000,30000,0,20000,10000
11/04/24,Food,Food,Noodles,8,6000,48000,0,40000,8000
11/04/24,Food,Food,Salmon,4,15000,60000,0,56000,4000
11/04/24,Food,Food,Macaroni,1,5000,5000,0,4000,1000
11/04/24,Food,Food,Fish & Chips,3,30000,90000,0,81000,9000
11/04/24,Food,Food,Burger,2,15000,30000,0,28000,2000
11/04/24,Food,Food,Hotdog,3,10000,30000,0,27000,3000
11/04/24,Food,Food,Pasta,1,18000,18000,0,16000,2000
11/04/24,Food,Snack,Chips,2,5000,10000,0,8000,2000
11/04/24,Food,Snack,Popcorn,1,7000,7000,0,6500,500
11/04/24,Food,Snack,Almonds,1,8000,8000,0,7000,1000
11/04/24,Food,Beverages,Lemon Tea,5,4000,20000,0,15000,5000
11/04/24,Food,Beverages,Ocha,2,4000,8000,0,7000,1000
11/04/24,Food,Beverages,Lychee Tea,3,6000,18000,0,15000,3000
11/04/24,Food,Beverages,Oolong Tea,1,6000,6000,0,5000,1000
11/04/24,Food,Beverages,Soda,3,5000,15000,0,12000,3000
11/05/24,Food,Food,Takoyaki,3,10000,30000,0,24000,6000
11/05/24,Food,Food,Steak,4,60000,240000,0,220000,20000
11/05/24,Food,Food,Rendang,1,10000,10000,0,8000,2000
11/05/24,Food,Food,Fried Chicken,10,3000,30000,0,20000,10000
11/05/24,Food,Food,Noodles,8,6000,48000,0,40000,8000
11/05/24,Food,Food,Salmon,4,15000,60000,0,56000,4000
11/05/24,Food,Food,Macaroni,1,5000,5000,0,4000,1000
11/05/24,Food,Food,Fish & Chips,3,30000,90000,0,81000,9000
11/05/24,Food,Food,Burger,2,15000,30000,0,28000,2000
11/05/24,Food,Food,Hotdog,3,10000,30000,0,27000,3000
11/05/24,Food,Food,Pasta,1,18000,18000,0,16000,2000
11/05/24,Food,Snack,Chips,2,5000,10000,0,8000,2000
11/05/24,Food,Snack,Popcorn,1,7000,7000,0,6500,500
11/05/24,Food,Snack,Almonds,1,8000,8000,0,7000,1000
11/05/24,Food,Beverages,Lemon Tea,5,4000,20000,0,15000,5000
11/05/24,Food,Beverages,Ocha,2,4000,8000,0,7000,1000
11/05/24,Food,Beverages,Lychee Tea,3,6000,18000,0,15000,3000
11/05/24,Food,Beverages,Oolong Tea,1,6000,6000,0,5000,1000
11/05/24,Food,Beverages,Soda,3,5000,15000,0,12000,3000
11/06/24,Food,Food,Takoyaki,3,10000,30000,0,24000,6000
11/06/24,Food,Food,Steak,4,60000,240000,0,220000,20000
11/06/24,Food,Food,Rendang,1,10000,10000,0,8000,2000
11/06/24,Food,Food,Fried Chicken,10,3000,30000,0,20000,10000
11/06/24,Food,Food,Noodles,8,6000,48000,0,40000,8000
11/06/24,Food,Food,Salmon,4,15000,60000,0,56000,4000
11/06/24,Food,Food,Macaroni,1,5000,5000,0,4000,1000
11/06/24,Food,Food,Fish & Chips,3,30000,90000,0,81000,9000
11/06/24,Food,Food,Burger,2,15000,30000,0,28000,2000
11/06/24,Food,Food,Hotdog,3,10000,30000,0,27000,3000
11/06/24,Food,Food,Pasta,1,18000,18000,0,16000,2000
11/06/24,Food,Snack,Chips,2,5000,10000,0,8000,2000
11/06/24,Food,Snack,Popcorn,1,7000,7000,0,6500,500
11/06/24,Food,Snack,Almonds,1,8000,8000,0,7000,1000
11/06/24,Food,Beverages,Lemon Tea,5,4000,20000,0,15000,5000
11/06/24,Food,Beverages,Ocha,2,4000,8000,0,7000,1000
11/06/24,Food,Beverages,Lychee Tea,3,6000,18000,0,15000,3000
11/06/24,Food,Beverages,Oolong Tea,1,6000,6000,0,5000,1000
11/06/24,Food,Beverages,Soda,3,5000,15000,0,12000,3000
11/07/24,Food,Food,Takoyaki,3,10000,30000,0,24000,6000
11/07/24,Food,Food,Steak,4,60000,240000,0,220000,20000
11/07/24,Food,Food,Rendang,1,10000,10000,0,8000,2000
11/07/24,Food,Food,Fried Chicken,10,3000,30000,0,20000,10000
11/07/24,Food,Food,Noodles,8,6000,48000,0,40000,8000
11/07/24,Food,Food,Salmon,4,15000,60000,0,56000,4000
11/07/24,Food,Food,Macaroni,1,5000,5000,0,4000,1000
11/07/24,Food,Food,Fish & Chips,3,30000,90000,0,81000,9000
11/07/24,Food,Food,Burger,2,15000,30000,0,28000,2000
11/07/24,Food,Food,Hotdog,3,10000,30000,0,27000,3000
11/07/24,Food,Food,Pasta,1,18000,18000,0,16000,2000
11/07/24,Food,Snack,Chips,2,5000,10000,0,8000,2000
11/07/24,Food,Snack,Popcorn,1,7000,7000,0,6500,500
11/07/24,Food,Snack,Almonds,1,8000,8000,0,7000,1000
11/07/24,Food,Beverages,Lemon Tea,5,4000,20000,0,15000,5000
11/07/24,Food,Beverages,Ocha,2,4000,8000,0,7000,1000
11/07/24,Food,Beverages,Lychee Tea,3,6000,18000,0,15000,3000
11/07/24,Food,Beverages,Oolong Tea,1,6000,6000,0,5000,1000
11/07/24,Food,Beverages,Soda,3,5000,15000,0,12000,3000
11/08/24,Food,Food,Takoyaki,3,10000,30000,0,24000,6000
11/08/24,Food,Food,Steak,4,60000,240000,0,220000,20000
11/08/24,Food,Food,Rendang,1,10000,10000,0,8000,2000
11/08/24,Food,Food,Fried Chicken,10,3000,30000,0,20000,10000
11/08/24,Food,Food,Noodles,8,6000,48000,0,40000,8000
11/08/24,Food,Food,Salmon,4,15000,60000,0,56000,4000
11/08/24,Food,Food,Macaroni,1,5000,5000,0,4000,1000
11/08/24,Food,Food,Fish & Chips,3,30000,90000,0,81000,9000
11/08/24,Food,Food,Burger,2,15000,30000,0,28000,2000
11/08/24,Food,Food,Hotdog,3,10000,30000,0,27000,3000
11/08/24,Food,Food,Pasta,1,18000,18000,0,16000,2000
11/08/24,Food,Snack,Chips,2,5000,10000,0,8000,2000
11/08/24,Food,Snack,Popcorn,1,7000,7000,0,6500,500
11/08/24,Food,Snack,Almonds,1,8000,8000,0,7000,1000
11/08/24,Food,Beverages,Lemon Tea,5,4000,20000,0,15000,5000
11/08/24,Food,Beverages,Ocha,2,4000,8000,0,7000,1000
11/08/24,Food,Beverages,Lychee Tea,3,6000,18000,0,15000,3000
11/08/24,Food,Beverages,Oolong Tea,1,6000,6000,0,5000,1000
11/08/24,Food,Beverages,Soda,3,5000,15000,0,12000,3000
11/09/24,Food,Food,Takoyaki,3,10000,30000,0,24000,6000
11/09/24,Food,Food,Steak,4,60000,240000,0,220000,20000
11/09/24,Food,Food,Rendang,1,10000,10000,0,8000,2000
11/09/24,Food,Food,Fried Chicken,10,3000,30000,0,20000,10000
11/09/24,Food,Food,Noodles,8,6000,48000,0,40000,8000
11/09/24,Food,Food,Salmon,4,15000,60000,0,56000,4000
11/09/24,Food,Food,Macaroni,1,5000,5000,0,4000,1000
11/09/24,Food,Food,Fish & Chips,3,30000,90000,0,81000,9000
11/09/24,Food,Food,Burger,2,15000,30000,0,28000,2000
11/09/24,Food,Food,Hotdog,3,10000,30000,0,27000,3000
11/09/24,Food,Food,Pasta,1,18000,18000,0,16000,2000
11/09/24,Food,Snack,Chips,2,5000,10000,0,8000,2000
11/09/24,Food,Snack,Popcorn,1,7000,7000,0,6500,500
11/09/24,Food,Snack,Almonds,1,8000,8000,0,7000,1000
11/09/24,Food,Beverages,Lemon Tea,5,4000,20000,0,15000,5000
11/09/24,Food,Beverages,Ocha,2,4000,8000,0,7000,1000
11/09/24,Food,Beverages,Lychee Tea,3,6000,18000,0,15000,3000
11/09/24,Food,Beverages,Oolong Tea,1,6000,6000,0,5000,1000
11/09/24,Food,Beverages,Soda,3,5000,15000,0,12000,3000
11/10/24,Food,Food,Takoyaki,3,10000,30000,0,24000,6000
11/10/24,Food,Food,Steak,4,60000,240000,0,220000,20000
11/10/24,Food,Food,Rendang,1,10000,10000,0,8000,2000
11/10/24,Food,Food,Fried Chicken,10,3000,30000,0,20000,10000
11/10/24,Food,Food,Noodles,8,6000,48000,0,40000,8000
11/10/24,Food,Food,Salmon,4,15000,60000,0,56000,4000
11/10/24,Food,Food,Macaroni,1,5000,5000,0,4000,1000
11/10/24,Food,Food,Fish & Chips,3,30000,90000,0,81000,9000
11/10/24,Food,Food,Burger,2,15000,30000,0,28000,2000
11/10/24,Food,Food,Hotdog,3,10000,30000,0,27000,3000
11/10/24,Food,Food,Pasta,1,18000,18000,0,16000,2000
11/10/24,Food,Snack,Chips,2,5000,10000,0,8000,2000
11/10/24,Food,Snack,Popcorn,1,7000,7000,0,6500,500
11/10/24,Food,Snack,Almonds,1,8000,8000,0,7000,1000
11/10/24,Food,Beverages,Lemon Tea,5,4000,20000,0,15000,5000
11/10/24,Food,Beverages,Ocha,2,4000,8000,0,7000,1000
11/10/24,Food,Beverages,Lychee Tea,3,6000,18000,0,15000,3000
11/10/24,Food,Beverages,Oolong Tea,1,6000,6000,0,5000,1000
11/10/24,Food,Beverages,Soda,3,5000,15000,0,12000,3000
11/11/24,Food,Food,Takoyaki,3,10000,30000,0,24000,6000
11/11/24,Food,Food,Steak,4,60000,240000,0,220000,20000
11/11/24,Food,Food,Rendang,1,10000,10000,0,8000,2000
11/11/24,Food,Food,Fried Chicken,10,3000,30000,0,20000,10000
11/11/24,Food,Food,Noodles,8,6000,48000,0,40000,8000
11/11/24,Food,Food,Salmon,4,15000,60000,0,56000,4000
11/11/24,Food,Food,Macaroni,1,5000,5000,0,4000,1000
11/11/24,Food,Food,Fish & Chips,3,30000,90000,0,81000,9000
11/11/24,Food,Food,Burger,2,15000,30000,0,28000,2000
11/11/24,Food,Food,Hotdog,3,10000,30000,0,27000,3000
11/11/24,Food,Food,Pasta,1,18000,18000,0,16000,2000
11/11/24,Food,Snack,Chips,2,5000,10000,0,8000,2000
11/11/24,Food,Snack,Popcorn,1,7000,7000,0,6500,500
11/11/24,Food,Snack,Almonds,1,8000,8000,0,7000,1000
11/11/24,Food,Beverages,Lemon Tea,5,4000,20000,0,15000,5000
11/11/24,Food,Beverages,Ocha,2,4000,8000,0,7000,1000
11/11/24,Food,Beverages,Lychee Tea,3,6000,18000,0,15000,3000
11/11/24,Food,Beverages,Oolong Tea,1,6000,6000,0,5000,1000
11/11/24,Food,Beverages,Soda,3,5000,15000,0,12000,3000
11/12/24,Food,Food,Takoyaki,3,10000,30000,0,24000,6000
11/12/24,Food,Food,Steak,4,60000,240000,0,220000,20000
11/12/24,Food,Food,Rendang,1,10000,10000,0,8000,2000
11/12/24,Food,Food,Fried Chicken,10,3000,30000,0,20000,10000
11/12/24,Food,Food,Noodles,8,6000,48000,0,40000,8000
11/12/24,Food,Food,Salmon,4,15000,60000,0,56000,4000
11/12/24,Food,Food,Macaroni,1,5000,5000,0,4000,1000
11/12/24,Food,Food,Fish & Chips,3,30000,90000,0,81000,9000
11/12/24,Food,Food,Burger,2,15000,30000,0,28000,2000
11/12/24,Food,Food,Hotdog,3,10000,30000,0,27000,3000
11/12/24,Food,Food,Pasta,1,18000,18000,0,16000,2000
11/12/24,Food,Snack,Chips,2,5000,10000,0,8000,2000
11/12/24,Food,Snack,Popcorn,1,7000,7000,0,6500,500
11/12/24,Food,Snack,Almonds,1,8000,8000,0,7000,1000
11/12/24,Food,Beverages,Lemon Tea,5,4000,20000,0,15000,5000
11/12/24,Food,Beverages,Ocha,2,4000,8000,0,7000,1000
11/12/24,Food,Beverages,Lychee Tea,3,6000,18000,0,15000,3000
11/12/24,Food,Beverages,Oolong Tea,1,6000,6000,0,5000,1000
11/12/24,Food,Beverages,Soda,3,5000,15000,0,12000,3000
11/13/24,Food,Food,Takoyaki,3,10000,30000,0,24000,6000
11/13/24,Food,Food,Steak,4,60000,240000,0,220000,20000
11/13/24,Food,Food,Rendang,1,10000,10000,0,8000,2000
11/13/24,Food,Food,Fried Chicken,10,3000,30000,0,20000,10000
11/13/24,Food,Food,Noodles,8,6000,48000,0,40000,8000
11/13/24,Food,Food,Salmon,4,15000,60000,0,56000,4000
11/13/24,Food,Food,Macaroni,1,5000,5000,0,4000,1000
11/13/24,Food,Food,Fish & Chips,3,30000,90000,0,81000,9000
11/13/24,Food,Food,Burger,2,15000,30000,0,28000,2000
11/13/24,Food,Food,Hotdog,3,10000,30000,0,27000,3000
11/13/24,Food,Food,Pasta,1,18000,18000,0,16000,2000
11/13/24,Food,Snack,Chips,2,5000,10000,0,8000,2000
11/13/24,Food,Snack,Popcorn,1,7000,7000,0,6500,500
11/13/24,Food,Snack,Almonds,1,8000,8000,0,7000,1000
11/13/24,Food,Beverages,Lemon Tea,5,4000,20000,0,15000,5000
11/13/24,Food,Beverages,Ocha,2,4000,8000,0,7000,1000
11/13/24,Food,Beverages,Lychee Tea,3,6000,18000,0,15000,3000
11/13/24,Food,Beverages,Oolong Tea,1,6000,6000,0,5000,1000
11/13/24,Food,Beverages,Soda,3,5000,15000,0,12000,3000
11/14/24,Food,Food,Takoyaki,3,10000,30000,0,24000,6000
11/14/24,Food,Food,Steak,4,60000,240000,0,220000,20000
11/14/24,Food,Food,Rendang,1,10000,10000,0,8000,2000
11/14/24,Food,Food,Fried Chicken,10,3000,30000,0,20000,10000
11/14/24,Food,Food,Noodles,8,6000,48000,0,40000,8000
11/14/24,Food,Food,Salmon,4,15000,60000,0,56000,4000
11/14/24,Food,Food,Macaroni,1,5000,5000,0,4000,1000
11/14/24,Food,Food,Fish & Chips,3,30000,90000,0,81000,9000
11/14/24,Food,Food,Burger,2,15000,30000,0,28000,2000
11/14/24,Food,Food,Hotdog,3,10000,30000,0,27000,3000
11/14/24,Food,Food,Pasta,1,18000,18000,0,16000,2000
11/14/24,Food,Snack,Chips,2,5000,10000,0,8000,2000
11/14/24,Food,Snack,Popcorn,1,7000,7000,0,6500,500
11/14/24,Food,Snack,Almonds,1,8000,8000,0,7000,1000
11/14/24,Food,Beverages,Lemon Tea,5,4000,20000,0,15000,5000
11/14/24,Food,Beverages,Ocha,2,4000,8000,0,7000,1000
11/14/24,Food,Beverages,Lychee Tea,3,6000,18000,0,15000,3000
11/14/24,Food,Beverages,Oolong Tea,1,6000,6000,0,5000,1000
11/14/24,Food,Beverages,Soda,3,5000,15000,0,12000,3000
11/15/24,Food,Food,Takoyaki,3,10000,30000,0,24000,6000
11/15/24,Food,Food,Steak,4,60000,240000,0,220000,20000
11/15/24,Food,Food,Rendang,1,10000,10000,0,8000,2000
11/15/24,Food,Food,Fried Chicken,10,3000,30000,0,20000,10000
11/15/24,Food,Food,Noodles,8,6000,48000,0,40000,8000
11/15/24,Food,Food,Salmon,4,15000,60000,0,56000,4000
11/15/24,Food,Food,Macaroni,1,5000,5000,0,4000,1000
11/15/24,Food,Food,Fish & Chips,3,30000,90000,0,81000,9000
11/15/24,Food,Food,Burger,2,15000,30000,0,28000,2000
11/15/24,Food,Food,Hotdog,3,10000,30000,0,27000,3000
11/15/24,Food,Food,Pasta,1,18000,18000,0,16000,2000
11/15/24,Food,Snack,Chips,2,5000,10000,0,8000,2000
11/15/24,Food,Snack,Popcorn,1,7000,7000,0,6500,500
11/15/24,Food,Snack,Almonds,1,8000,8000,0,7000,1000
11/15/24,Food,Beverages,Lemon Tea,5,4000,20000,0,15000,5000
11/15/24,Food,Beverages,Ocha,2,4000,8000,0,7000,1000
11/15/24,Food,Beverages,Lychee Tea,3,6000,18000,0,15000,3000
11/15/24,Food,Beverages,Oolong Tea,1,6000,6000,0,5000,1000
11/15/24,Food,Beverages,Soda,3,5000,15000,0,12000,3000
11/16/24,Food,Food,Takoyaki,3,10000,30000,0,24000,6000
11/16/24,Food,Food,Steak,4,60000,240000,0,220000,20000
11/16/24,Food,Food,Rendang,1,10000,10000,0,8000,2000
11/16/24,Food,Food,Fried Chicken,10,3000,30000,0,20000,10000
11/16/24,Food,Food,Noodles,8,6000,48000,0,40000,8000
11/16/24,Food,Food,Salmon,4,15000,60000,0,56000,4000
11/16/24,Food,Food,Macaroni,1,5000,5000,0,4000,1000
11/16/24,Food,Food,Fish & Chips,3,30000,90000,0,81000,9000
11/16/24,Food,Food,Burger,2,15000,30000,0,28000,2000
11/16/24,Food,Food,Hotdog,3,10000,30000,0,27000,3000
11/16/24,Food,Food,Pasta,1,18000,18000,0,16000,2000
11/16/24,Food,Snack,Chips,2,5000,10000,0,8000,2000
11/16/24,Food,Snack,Popcorn,1,7000,7000,0,6500,500
11/16/24,Food,Snack,Almonds,1,8000,8000,0,7000,1000
11/16/24,Food,Beverages,Lemon Tea,5,4000,20000,0,15000,5000
11/16/24,Food,Beverages,Ocha,2,4000,8000,0,7000,1000
11/16/24,Food,Beverages,Lychee Tea,3,6000,18000,0,15000,3000
11/16/24,Food,Beverages,Oolong Tea,1,6000,6000,0,5000,1000
11/16/24,Food,Beverages,Soda,3,5000,15000,0,12000,3000
11/17/24,Food,Food,Takoyaki,3,10000,30000,0,24000,6000
11/17/24,Food,Food,Steak,4,60000,240000,0,220000,20000
11/17/24,Food,Food,Rendang,1,10000,10000,0,8000,2000
11/17/24,Food,Food,Fried Chicken,10,3000,30000,0,20000,10000
11/17/24,Food,Food,Noodles,8,6000,48000,0,40000,8000
11/17/24,Food,Food,Salmon,4,15000,60000,0,56000,4000
11/17/24,Food,Food,Macaroni,1,5000,5000,0,4000,1000
11/17/24,Food,Food,Fish & Chips,3,30000,90000,0,81000,9000
11/17/24,Food,Food,Burger,2,15000,30000,0,28000,2000
11/17/24,Food,Food,Hotdog,3,10000,30000,0,27000,3000
11/17/24,Food,Food,Pasta,1,18000,18000,0,16000,2000
11/17/24,Food,Snack,Chips,2,5000,10000,0,8000,2000
11/17/24,Food,Snack,Popcorn,1,7000,7000,0,6500,500
11/17/24,Food,Snack,Almonds,1,8000,8000,0,7000,1000
11/17/24,Food,Beverages,Lemon Tea,5,4000,20000,0,15000,5000
11/17/24,Food,Beverages,Ocha,2,4000,8000,0,7000,1000
11/17/24,Food,Beverages,Lychee Tea,3,6000,18000,0,15000,3000
11/17/24,Food,Beverages,Oolong Tea,1,6000,6000,0,5000,1000
11/17/24,Food,Beverages,Soda,3,5000,15000,0,12000,3000
11/18/24,Food,Food,Takoyaki,3,10000,30000,0,24000,6000
11/18/24,Food,Food,Steak,4,60000,240000,0,220000,20000
11/18/24,Food,Food,Rendang,1,10000,10000,0,8000,2000
11/18/24,Food,Food,Fried Chicken,10,3000,30000,0,20000,10000
11/18/24,Food,Food,Noodles,8,6000,48000,0,40000,8000
11/18/24,Food,Food,Salmon,4,15000,60000,0,56000,4000
11/18/24,Food,Food,Macaroni,1,5000,5000,0,4000,1000
11/18/24,Food,Food,Fish & Chips,3,30000,90000,0,81000,9000
11/18/24,Food,Food,Burger,2,15000,30000,0,28000,2000
11/18/24,Food,Food,Hotdog,3,10000,30000,0,27000,3000
11/18/24,Food,Food,Pasta,1,18000,18000,0,16000,2000
11/18/24,Food,Snack,Chips,2,5000,10000,0,8000,2000
11/18/24,Food,Snack,Popcorn,1,7000,7000,0,6500,500
11/18/24,Food,Snack,Almonds,1,8000,8000,0,7000,1000
11/18/24,Food,Beverages,Lemon Tea,5,4000,20000,0,15000,5000
11/18/24,Food,Beverages,Ocha,2,4000,8000,0,7000,1000
11/18/24,Food,Beverages,Lychee Tea,3,6000,18000,0,15000,3000
11/18/24,Food,Beverages,Oolong Tea,1,6000,6000,0,5000,1000
11/18/24,Food,Beverages,Soda,3,5000,15000,0,12000,3000
11/19/24,Food,Food,Takoyaki,3,10000,30000,0,24000,6000
11/19/24,Food,Food,Steak,4,60000,240000,0,220000,20000
11/19/24,Food,Food,Rendang,1,10000,10000,0,8000,2000
11/19/24,Food,Food,Fried Chicken,10,3000,30000,0,20000,10000
11/19/24,Food,Food,Noodles,8,6000,48000,0,40000,8000
11/19/24,Food,Food,Salmon,4,15000,60000,0,56000,4000
11/19/24,Food,Food,Macaroni,1,5000,5000,0,4000,1000
11/19/24,Food,Food,Fish & Chips,3,30000,90000,0,81000,9000
11/19/24,Food,Food,Burger,2,15000,30000,0,28000,2000
11/19/24,Food,Food,Hotdog,3,10000,30000,0,27000,3000
11/19/24,Food,Food,Pasta,1,18000,18000,0,16000,2000
11/19/24,Food,Snack,Chips,2,5000,10000,0,8000,2000
11/19/24,Food,Snack,Popcorn,1,7000,7000,0,6500,500
11/19/24,Food,Snack,Almonds,1,8000,8000,0,7000,1000
11/19/24,Food,Beverages,Lemon Tea,5,4000,20000,0,15000,5000
11/19/24,Food,Beverages,Ocha,2,4000,8000,0,7000,1000
11/19/24,Food,Beverages,Lychee Tea,3,6000,18000,0,15000,3000
11/19/24,Food,Beverages,Oolong Tea,1,6000,6000,0,5000,1000
11/19/24,Food,Beverages,Soda,3,5000,15000,0,12000,3000
11/20/24,Food,Food,Takoyaki,3,10000,30000,0,24000,6000
11/20/24,Food,Food,Steak,4,60000,240000,0,220000,20000
11/20/24,Food,Food,Rendang,1,10000,10000,0,8000,2000
11/20/24,Food,Food,Fried Chicken,10,3000,30000,0,20000,10000
11/20/24,Food,Food,Noodles,8,6000,48000,0,40000,8000
11/20/24,Food,Food,Salmon,4,15000,60000,0,56000,4000
11/20/24,Food,Food,Macaroni,1,5000,5000,0,4000,1000
11/20/24,Food,Food,Fish & Chips,3,30000,90000,0,81000,9000
11/20/24,Food,Food,Burger,2,15000,30000,0,28000,2000
11/20/24,Food,Food,Hotdog,3,10000,30000,0,27000,3000
11/20/24,Food,Food,Pasta,1,18000,18000,0,16000,2000
11/20/24,Food,Snack,Chips,2,5000,10000,0,8000,2000
11/20/24,Food,Snack,Popcorn,1,7000,7000,0,6500,500
11/20/24,Food,Snack,Almonds,1,8000,8000,0,7000,1000
11/20/24,Food,Beverages,Lemon Tea,5,4000,20000,0,15000,5000
11/20/24,Food,Beverages,Ocha,2,4000,8000,0,7000,1000
11/20/24,Food,Beverages,Lychee Tea,3,6000,18000,0,15000,3000
11/20/24,Food,Beverages,Oolong Tea,1,6000,6000,0,5000,1000
11/20/24,Food,Beverages,Soda,3,5000,15000,0,12000,3000
11/21/24,Food,Food,Takoyaki,3,10000,30000,0,24000,6000
11/21/24,Food,Food,Steak,4,60000,240000,0,220000,20000
11/21/24,Food,Food,Rendang,1,10000,10000,0,8000,2000
11/21/24,Food,Food,Fried Chicken,10,3000,30000,0,20000,10000
11/21/24,Food,Food,Noodles,8,6000,48000,0,40000,8000
11/21/24,Food,Food,Salmon,4,15000,60000,0,56000,4000
11/21/24,Food,Food,Macaroni,1,5000,5000,0,4000,1000
11/21/24,Food,Food,Fish & Chips,3,30000,90000,0,81000,9000
11/21/24,Food,Food,Burger,2,15000,30000,0,28000,2000
11/21/24,Food,Food,Hotdog,3,10000,30000,0,27000,3000
11/21/24,Food,Food,Pasta,1,18000,18000,0,16000,2000
11/21/24,Food,Snack,Chips,2,5000,10000,0,8000,2000
11/21/24,Food,Snack,Popcorn,1,7000,7000,0,6500,500
11/21/24,Food,Snack,Almonds,1,8000,8000,0,7000,1000
11/21/24,Food,Beverages,Lemon Tea,5,4000,20000,0,15000,5000
11/21/24,Food,Beverages,Ocha,2,4000,8000,0,7000,1000
11/21/24,Food,Beverages,Lychee Tea,3,6000,18000,0,15000,3000
11/21/24,Food,Beverages,Oolong Tea,1,6000,6000,0,5000,1000
11/21/24,Food,Beverages,Soda,3,5000,15000,0,12000,3000
11/22/24,Food,Food,Takoyaki,3,10000,30000,0,24000,6000
11/22/24,Food,Food,Steak,4,60000,240000,0,220000,20000
11/22/24,Food,Food,Rendang,1,10000,10000,0,8000,2000
11/22/24,Food,Food,Fried Chicken,10,3000,30000,0,20000,10000
11/22/24,Food,Food,Noodles,8,6000,48000,0,40000,8000
11/22/24,Food,Food,Salmon,4,15000,60000,0,56000,4000
11/22/24,Food,Food,Macaroni,1,5000,5000,0,4000,1000
11/22/24,Food,Food,Fish & Chips,3,30000,90000,0,81000,9000
11/22/24,Food,Food,Burger,2,15000,30000,0,28000,2000
11/22/24,Food,Food,Hotdog,3,10000,30000,0,27000,3000
11/22/24,Food,Food,Pasta,1,18000,18000,0,16000,2000
11/22/24,Food,Snack,Chips,2,5000,10000,0,8000,2000
11/22/24,Food,Snack,Popcorn,1,7000,7000,0,6500,500
11/22/24,Food,Snack,Almonds,1,8000,8000,0,7000,1000
11/22/24,Food,Beverages,Lemon Tea,5,4000,20000,0,15000,5000
11/22/24,Food,Beverages,Ocha,2,4000,8000,0,7000,1000
11/22/24,Food,Beverages,Lychee Tea,3,6000,18000,0,15000,3000
11/22/24,Food,Beverages,Oolong Tea,1,6000,6000,0,5000,1000
11/22/24,Food,Beverages,Soda,3,5000,15000,0,12000,3000
11/23/24,Food,Food,Takoyaki,3,10000,30000,0,24000,6000
11/23/24,Food,Food,Steak,4,60000,240000,0,220000,20000
11/23/24,Food,Food,Rendang,1,10000,10000,0,8000,2000
11/23/24,Food,Food,Fried Chicken,10,3000,30000,0,20000,10000
11/23/24,Food,Food,Noodles,8,6000,48000,0,40000,8000
11/23/24,Food,Food,Salmon,4,15000,60000,0,56000,4000
11/23/24,Food,Food,Macaroni,1,5000,5000,0,4000,1000
11/23/24,Food,Food,Fish & Chips,3,30000,90000,0,81000,9000
11/23/24,Food,Food,Burger,2,15000,30000,0,28000,2000
11/23/24,Food,Food,Hotdog,3,10000,30000,0,27000,3000
11/23/24,Food,Food,Pasta,1,18000,18000,0,16000,2000
11/23/24,Food,Snack,Chips,2,5000,10000,0,8000,2000
11/23/24,Food,Snack,Popcorn,1,7000,7000,0,6500,500
11/23/24,Food,Snack,Almonds,1,8000,8000,0,7000,1000
11/23/24,Food,Beverages,Lemon Tea,5,4000,20000,0,15000,5000
11/23/24,Food,Beverages,Ocha,2,4000,8000,0,7000,1000
11/23/24,Food,Beverages,Lychee Tea,3,6000,18000,0,15000,3000
11/23/24,Food,Beverages,Oolong Tea,1,6000,6000,0,5000,1000
11/23/24,Food,Beverages,Soda,3,5000,15000,0,12000,3000
11/24/24,Food,Food,Takoyaki,3,10000,30000,0,24000,6000
11/24/24,Food,Food,Steak,4,60000,240000,0,220000,20000
11/24/24,Food,Food,Rendang,1,10000,10000,0,8000,2000
11/24/24,Food,Food,Fried Chicken,10,3000,30000,0,20000,10000
11/24/24,Food,Food,Noodles,8,6000,48000,0,40000,8000
11/24/24,Food,Food,Salmon,4,15000,60000,0,56000,4000
11/24/24,Food,Food,Macaroni,1,5000,5000,0,4000,1000
11/24/24,Food,Food,Fish & Chips,3,30000,90000,0,81000,9000
11/24/24,Food,Food,Burger,2,15000,30000,0,28000,2000
11/24/24,Food,Food,Hotdog,3,10000,30000,0,27000,3000
11/24/24,Food,Food,Pasta,1,18000,18000,0,16000,2000
11/24/24,Food,Snack,Chips,2,5000,10000,0,8000,2000
11/24/24,Food,Snack,Popcorn,1,7000,7000,0,6500,500
11/24/24,Food,Snack,Almonds,1,8000,8000,0,7000,1000
11/24/24,Food,Beverages,Lemon Tea,5,4000,20000,0,15000,5000
11/24/24,Food,Beverages,Ocha,2,4000,8000,0,7000,1000
11/24/24,Food,Beverages,Lychee Tea,3,6000,18000,0,15000,3000
11/24/24,Food,Beverages,Oolong Tea,1,6000,6000,0,5000,1000
11/24/24,Food,Beverages,Soda,3,5000,15000,0,12000,3000
11/25/24,Food,Food,Takoyaki,3,10000,30000,0,24000,6000
11/25/24,Food,Food,Steak,4,60000,240000,0,220000,20000
11/25/24,Food,Food,Rendang,1,10000,10000,0,8000,2000
11/25/24,Food,Food,Fried Chicken,10,3000,30000,0,20000,10000
11/25/24,Food,Food,Noodles,8,6000,48000,0,40000,8000
11/25/24,Food,Food,Salmon,4,15000,60000,0,56000,4000
11/25/24,Food,Food,Macaroni,1,5000,5000,0,4000,1000
11/25/24,Food,Food,Fish & Chips,3,30000,90000,0,81000,9000
11/25/24,Food,Food,Burger,2,15000,30000,0,28000,2000
11/25/24,Food,Food,Hotdog,3,10000,30000,0,27000,3000
11/25/24,Food,Food,Pasta,1,18000,18000,0,16000,2000
11/25/24,Food,Snack,Chips,2,5000,10000,0,8000,2000
11/25/24,Food,Snack,Popcorn,1,7000,7000,0,6500,500
11/25/24,Food,Snack,Almonds,1,8000,8000,0,7000,1000
11/25/24,Food,Beverages,Lemon Tea,5,4000,20000,0,15000,5000
11/25/24,Food,Beverages,Ocha,2,4000,8000,0,7000,1000
11/25/24,Food,Beverages,Lychee Tea,3,6000,18000,0,15000,3000
11/25/24,Food,Beverages,Oolong Tea,1,6000,6000,0,5000,1000
11/25/24,Food,Beverages,Soda,3,5000,15000,0,12000,3000
11/26/24,Food,Food,Takoyaki,3,10000,30000,0,24000,6000
11/26/24,Food,Food,Steak,4,60000,240000,0,220000,20000
11/26/24,Food,Food,Rendang,1,10000,10000,0,8000,2000
11/26/24,Food,Food,Fried Chicken,10,3000,30000,0,20000,10000
11/26/24,Food,Food,Noodles,8,6000,48000,0,40000,8000
11/26/24,Food,Food,Salmon,4,15000,60000,0,56000,4000
11/26/24,Food,Food,Macaroni,1,5000,5000,0,4000,1000
11/26/24,Food,Food,Fish & Chips,3,30000,90000,0,81000,9000
11/26/24,Food,Food,Burger,2,15000,30000,0,28000,2000
11/26/24,Food,Food,Hotdog,3,10000,30000,0,27000,3000
11/26/24,Food,Food,Pasta,1,18000,18000,0,16000,2000
11/26/24,Food,Snack,Chips,2,5000,10000,0,8000,2000
11/26/24,Food,Snack,Popcorn,1,7000,7000,0,6500,500
11/26/24,Food,Snack,Almonds,1,8000,8000,0,7000,1000
11/26/24,Food,Beverages,Lemon Tea,5,4000,20000,0,15000,5000
11/26/24,Food,Beverages,Ocha,2,4000,8000,0,7000,1000
11/26/24,Food,Beverages,Lychee Tea,3,6000,18000,0,15000,3000
11/26/24,Food,Beverages,Oolong Tea,1,6000,6000,0,5000,1000
11/26/24,Food,Beverages,Soda,3,5000,15000,0,12000,3000
11/27/24,Food,Food,Takoyaki,3,10000,30000,0,24000,6000
11/27/24,Food,Food,Steak,4,60000,240000,0,220000,20000
11/27/24,Food,Food,Rendang,1,10000,10000,0,8000,2000
11/27/24,Food,Food,Fried Chicken,10,3000,30000,0,20000,10000
11/27/24,Food,Food,Noodles,8,6000,48000,0,40000,8000
11/27/24,Food,Food,Salmon,4,15000,60000,0,56000,4000
11/27/24,Food,Food,Macaroni,1,5000,5000,0,4000,1000
11/27/24,Food,Food,Fish & Chips,3,30000,90000,0,81000,9000
11/27/24,Food,Food,Burger,2,15000,30000,0,28000,2000
11/27/24,Food,Food,Hotdog,3,10000,30000,0,27000,3000
11/27/24,Food,Food,Pasta,1,18000,18000,0,16000,2000
11/27/24,Food,Snack,Chips,2,5000,10000,0,8000,2000
11/27/24,Food,Snack,Popcorn,1,7000,7000,0,6500,500
11/27/24,Food,Snack,Almonds,1,8000,8000,0,7000,1000
11/27/24,Food,Beverages,Lemon Tea,5,4000,20000,0,15000,5000
11/27/24,Food,Beverages,Ocha,2,4000,8000,0,7000,1000
11/27/24,Food,Beverages,Lychee Tea,3,6000,18000,0,15000,3000
11/27/24,Food,Beverages,Oolong Tea,1,6000,6000,0,5000,1000
11/27/24,Food,Beverages,Soda,3,5000,15000,0,12000,3000
11/28/24,Food,Food,Takoyaki,3,10000,30000,0,24000,6000
11/28/24,Food,Food,Steak,4,60000,240000,0,220000,20000
11/28/24,Food,Food,Rendang,1,10000,10000,0,8000,2000
11/28/24,Food,Food,Fried Chicken,10,3000,30000,0,20000,10000
11/28/24,Food,Food,Noodles,8,6000,48000,0,40000,8000
11/28/24,Food,Food,Salmon,4,15000,60000,0,56000,4000
11/28/24,Food,Food,Macaroni,1,5000,5000,0,4000,1000
11/28/24,Food,Food,Fish & Chips,3,30000,90000,0,81000,9000
11/28/24,Food,Food,Burger,2,15000,30000,0,28000,2000
11/28/24,Food,Food,Hotdog,3,10000,30000,0,27000,3000
11/28/24,Food,Food,Pasta,1,18000,18000,0,16000,2000
11/28/24,Food,Snack,Chips,2,5000,10000,0,8000,2000
11/28/24,Food,Snack,Popcorn,1,7000,7000,0,6500,500
11/28/24,Food,Snack,Almonds,1,8000,8000,0,7000,1000
11/28/24,Food,Beverages,Lemon Tea,5,4000,20000,0,15000,5000
11/28/24,Food,Beverages,Ocha,2,4000,8000,0,7000,1000
11/28/24,Food,Beverages,Lychee Tea,3,6000,18000,0,15000,3000
11/28/24,Food,Beverages,Oolong Tea,1,6000,6000,0,5000,1000
11/28/24,Food,Beverages,Soda,3,5000,15000,0,12000,3000
11/29/24,Food,Food,Takoyaki,3,10000,30000,0,24000,6000
11/29/24,Food,Food,Steak,4,60000,240000,0,220000,20000
11/29/24,Food,Food,Rendang,1,10000,10000,0,8000,2000
11/29/24,Food,Food,Fried Chicken,10,3000,30000,0,20000,10000
11/29/24,Food,Food,Noodles,8,6000,48000,0,40000,8000
11/29/24,Food,Food,Salmon,4,15000,60000,0,56000,4000
11/29/24,Food,Food,Macaroni,1,5000,5000,0,4000,1000
11/29/24,Food,Food,Fish & Chips,3,30000,90000,0,81000,9000
11/29/24,Food,Food,Burger,2,15000,30000,0,28000,2000
11/29/24,Food,Food,Hotdog,3,10000,30000,0,27000,3000
11/29/24,Food,Food,Pasta,1,18000,18000,0,16000,2000
11/29/24,Food,Snack,Chips,2,5000,10000,0,8000,2000
11/29/24,Food,Snack,Popcorn,1,7000,7000,0,6500,500
11/29/24,Food,Snack,Almonds,1,8000,8000,0,7000,1000
11/29/24,Food,Beverages,Lemon Tea,5,4000,20000,0,15000,5000
11/29/24,Food,Beverages,Ocha,2,4000,8000,0,7000,1000
11/29/24,Food,Beverages,Lychee Tea,3,6000,18000,0,15000,3000
11/29/24,Food,Beverages,Oolong Tea,1,6000,6000,0,5000,1000
11/29/24,Food,Beverages,Soda,3,5000,15000,0,12000,3000
11/30/24,Food,Food,Takoyaki,3,10000,30000,0,24000,6000
11/30/24,Food,Food,Steak,4,60000,240000,0,220000,20000
11/30/24,Food,Food,Rendang,1,10000,10000,0,8000,2000
11/30/24,Food,Food,Fried Chicken,10,3000,30000,0,20000,10000
11/30/24,Food,Food,Noodles,8,6000,48000,0,40000,8000
11/30/24,Food,Food,Salmon,4,15000,60000,0,56000,4000
11/30/24,Food,Food,Macaroni,1,5000,5000,0,4000,1000
11/30/24,Food,Food,Fish & Chips,3,30000,90000,0,81000,9000
11/30/24,Food,Food,Burger,2,15000,30000,0,28000,2000
11/30/24,Food,Food,Hotdog,3,10000,30000,0,27000,3000
11/30/24,Food,Food,Pasta,1,18000,18000,0,16000,2000
11/30/24,Food,Snack,Chips,2,5000,10000,0,8000,2000
11/30/24,Food,Snack,Popcorn,1,7000,7000,0,6500,500
11/30/24,Food,Snack,Almonds,1,8000,8000,0,7000,1000
11/30/24,Food,Beverages,Lemon Tea,5,4000,20000,0,15000,5000
11/30/24,Food,Beverages,Ocha,2,4000,8000,0,7000,1000
11/30/24,Food,Beverages,Lychee Tea,3,6000,18000,0,15000,3000
11/30/24,Food,Beverages,Oolong Tea,1,6000,6000,0,5000,1000
11/30/24,Food,Beverages,Soda,3,5000,15000,0,12000,3000
12/01/24,Food,Food,Takoyaki,3,10000,30000,0,24000,6000
12/01/24,Food,Food,Steak,4,60000,240000,0,220000,20000
12/01/24,Food,Food,Rendang,1,10000,10000,0,8000,2000
12/01/24,Food,Food,Fried Chicken,10,3000,30000,0,20000,10000
12/01/24,Food,Food,Noodles,8,6000,48000,0,40000,8000
12/01/24,Food,Food,Salmon,4,15000,60000,0,56000,4000
12/01/24,Food,Food,Macaroni,1,5000,5000,0,4000,1000
12/01/24,Food,Food,Fish & Chips,3,30000,90000,0,81000,9000
12/01/24,Food,Food,Burger,2,15000,30000,0,28000,2000
12/01/24,Food,Food,Hotdog,3,10000,30000,0,27000,3000
12/01/24,Food,Food,Pasta,1,18000,18000,0,16000,2000
12/01/24,Food,Snack,Chips,2,5000,10000,0,8000,2000
12/01/24,Food,Snack,Popcorn,1,7000,7000,0,6500,500
12/01/24,Food,Snack,Almonds,1,8000,8000,0,7000,1000
12/01/24,Food,Beverages,Lemon Tea,5,4000,20000,0,15000,5000
12/01/24,Food,Beverages,Ocha,2,4000,8000,0,7000,1000
12/01/24,Food,Beverages,Lychee Tea,3,6000,18000,0,15000,3000
12/01/24,Food,Beverages,Oolong Tea,1,6000,6000,0,5000,1000
12/01/24,Food,Beverages,Soda,3,5000,15000,0,12000,3000
12/02/24,Food,Food,Takoyaki,3,10000,30000,0,24000,6000
12/02/24,Food,Food,Steak,4,60000,240000,0,220000,20000
12/02/24,Food,Food,Rendang,1,10000,10000,0,8000,2000
12/02/24,Food,Food,Fried Chicken,10,3000,30000,0,20000,10000
12/02/24,Food,Food,Noodles,8,6000,48000,0,40000,8000
12/02/24,Food,Food,Salmon,4,15000,60000,0,56000,4000
12/02/24,Food,Food,Macaroni,1,5000,5000,0,4000,1000
12/02/24,Food,Food,Fish & Chips,3,30000,90000,0,81000,9000
12/02/24,Food,Food,Burger,2,15000,30000,0,28000,2000
12/02/24,Food,Food,Hotdog,3,10000,30000,0,27000,3000
12/02/24,Food,Food,Pasta,1,18000,18000,0,16000,2000
12/02/24,Food,Snack,Chips,2,5000,10000,0,8000,2000
12/02/24,Food,Snack,Popcorn,1,7000,7000,0,6500,500
12/02/24,Food,Snack,Almonds,1,8000,8000,0,7000,1000
12/02/24,Food,Beverages,Lemon Tea,5,4000,20000,0,15000,5000
12/02/24,Food,Beverages,Ocha,2,4000,8000,0,7000,1000
12/02/24,Food,Beverages,Lychee Tea,3,6000,18000,0,15000,3000
12/02/24,Food,Beverages,Oolong Tea,1,6000,6000,0,5000,1000
12/02/24,Food,Beverages,Soda,3,5000,15000,0,12000,3000
12/03/24,Food,Food,Takoyaki,3,10000,30000,0,24000,6000
12/03/24,Food,Food,Steak,4,60000,240000,0,220000,20000
12/03/24,Food,Food,Rendang,1,10000,10000,0,8000,2000
12/03/24,Food,Food,Fried Chicken,10,3000,30000,0,20000,10000
12/03/24,Food,Food,Noodles,8,6000,48000,0,40000,8000
12/03/24,Food,Food,Salmon,4,15000,60000,0,56000,4000
12/03/24,Food,Food,Macaroni,1,5000,5000,0,4000,1000
12/03/24,Food,Food,Fish & Chips,3,30000,90000,0,81000,9000
12/03/24,Food,Food,Burger,2,15000,30000,0,28000,2000
12/03/24,Food,Food,Hotdog,3,10000,30000,0,27000,3000
12/03/24,Food,Food,Pasta,1,18000,18000,0,16000,2000
12/03/24,Food,Snack,Chips,2,5000,10000,0,8000,2000
12/03/24,Food,Snack,Popcorn,1,7000,7000,0,6500,500
12/03/24,Food,Snack,Almonds,1,8000,8000,0,7000,1000
12/03/24,Food,Beverages,Lemon Tea,5,4000,20000,0,15000,5000
12/03/24,Food,Beverages,Ocha,2,4000,8000,0,7000,1000
12/03/24,Food,Beverages,Lychee Tea,3,6000,18000,0,15000,3000
12/03/24,Food,Beverages,Oolong Tea,1,6000,6000,0,5000,1000
12/03/24,Food,Beverages,Soda,3,5000,15000,0,12000,3000
12/04/24,Food,Food,Takoyaki,3,10000,30000,0,24000,6000
12/04/24,Food,Food,Steak,4,60000,240000,0,220000,20000
12/04/24,Food,Food,Rendang,1,10000,10000,0,8000,2000
12/04/24,Food,Food,Fried Chicken,10,3000,30000,0,20000,10000
12/04/24,Food,Food,Noodles,8,6000,48000,0,40000,8000
12/04/24,Food,Food,Salmon,4,15000,60000,0,56000,4000
12/04/24,Food,Food,Macaroni,1,5000,5000,0,4000,1000
12/04/24,Food,Food,Fish & Chips,3,30000,90000,0,81000,9000
12/04/24,Food,Food,Burger,2,15000,30000,0,28000,2000
12/04/24,Food,Food,Hotdog,3,10000,30000,0,27000,3000
12/04/24,Food,Food,Pasta,1,18000,18000,0,16000,2000
12/04/24,Food,Snack,Chips,2,5000,10000,0,8000,2000
12/04/24,Food,Snack,Popcorn,1,7000,7000,0,6500,500
12/04/24,Food,Snack,Almonds,1,8000,8000,0,7000,1000
12/04/24,Food,Beverages,Lemon Tea,5,4000,20000,0,15000,5000
12/04/24,Food,Beverages,Ocha,2,4000,8000,0,7000,1000
12/04/24,Food,Beverages,Lychee Tea,3,6000,18000,0,15000,3000
12/04/24,Food,Beverages,Oolong Tea,1,6000,6000,0,5000,1000
12/04/24,Food,Beverages,Soda,3,5000,15000,0,12000,3000
12/05/24,Food,Food,Takoyaki,3,10000,30000,0,24000,6000
12/05/24,Food,Food,Steak,4,60000,240000,0,220000,20000
12/05/24,Food,Food,Rendang,1,10000,10000,0,8000,2000
12/05/24,Food,Food,Fried Chicken,10,3000,30000,0,20000,10000
12/05/24,Food,Food,Noodles,8,6000,48000,0,40000,8000
12/05/24,Food,Food,Salmon,4,15000,60000,0,56000,4000
12/05/24,Food,Food,Macaroni,1,5000,5000,0,4000,1000
12/05/24,Food,Food,Fish & Chips,3,30000,90000,0,81000,9000
12/05/24,Food,Food,Burger,2,15000,30000,0,28000,2000
12/05/24,Food,Food,Hotdog,3,10000,30000,0,27000,3000
12/05/24,Food,Food,Pasta,1,18000,18000,0,16000,2000
12/05/24,Food,Snack,Chips,2,5000,10000,0,8000,2000
12/05/24,Food,Snack,Popcorn,1,7000,7000,0,6500,500
12/05/24,Food,Snack,Almonds,1,8000,8000,0,7000,1000
12/05/24,Food,Beverages,Lemon Tea,5,4000,20000,0,15000,5000
12/05/24,Food,Beverages,Ocha,2,4000,8000,0,7000,1000
12/05/24,Food,Beverages,Lychee Tea,3,6000,18000,0,15000,3000
12/05/24,Food,Beverages,Oolong Tea,1,6000,6000,0,5000,1000
12/05/24,Food,Beverages,Soda,3,5000,15000,0,12000,3000
12/06/24,Food,Food,Takoyaki,3,10000,30000,0,24000,6000
12/06/24,Food,Food,Steak,4,60000,240000,0,220000,20000
12/06/24,Food,Food,Rendang,1,10000,10000,0,8000,2000
12/06/24,Food,Food,Fried Chicken,10,3000,30000,0,20000,10000
12/06/24,Food,Food,Noodles,8,6000,48000,0,40000,8000
12/06/24,Food,Food,Salmon,4,15000,60000,0,56000,4000
12/06/24,Food,Food,Macaroni,1,5000,5000,0,4000,1000
12/06/24,Food,Food,Fish & Chips,3,30000,90000,0,81000,9000
12/06/24,Food,Food,Burger,2,15000,30000,0,28000,2000
12/06/24,Food,Food,Hotdog,3,10000,30000,0,27000,3000
12/06/24,Food,Food,Pasta,1,18000,18000,0,16000,2000
12/06/24,Food,Snack,Chips,2,5000,10000,0,8000,2000
12/06/24,Food,Snack,Popcorn,1,7000,7000,0,6500,500
12/06/24,Food,Snack,Almonds,1,8000,8000,0,7000,1000
12/06/24,Food,Beverages,Lemon Tea,5,4000,20000,0,15000,5000
12/06/24,Food,Beverages,Ocha,2,4000,8000,0,7000,1000
12/06/24,Food,Beverages,Lychee Tea,3,6000,18000,0,15000,3000
12/06/24,Food,Beverages,Oolong Tea,1,6000,6000,0,5000,1000
12/06/24,Food,Beverages,Soda,3,5000,15000,0,12000,3000
12/07/24,Food,Food,Takoyaki,3,10000,30000,0,24000,6000
12/07/24,Food,Food,Steak,4,60000,240000,0,220000,20000
12/07/24,Food,Food,Rendang,1,10000,10000,0,8000,2000
12/07/24,Food,Food,Fried Chicken,10,3000,30000,0,20000,10000
12/07/24,Food,Food,Noodles,8,6000,48000,0,40000,8000
12/07/24,Food,Food,Salmon,4,15000,60000,0,56000,4000
12/07/24,Food,Food,Macaroni,1,5000,5000,0,4000,1000
12/07/24,Food,Food,Fish & Chips,3,30000,90000,0,81000,9000
12/07/24,Food,Food,Burger,2,15000,30000,0,28000,2000
12/07/24,Food,Food,Hotdog,3,10000,30000,0,27000,3000
12/07/24,Food,Food,Pasta,1,18000,18000,0,16000,2000
12/07/24,Food,Snack,Chips,2,5000,10000,0,8000,2000
12/07/24,Food,Snack,Popcorn,1,7000,7000,0,6500,500
12/07/24,Food,Snack,Almonds,1,8000,8000,0,7000,1000
12/07/24,Food,Beverages,Lemon Tea,5,4000,20000,0,15000,5000
12/07/24,Food,Beverages,Ocha,2,4000,8000,0,7000,1000
12/07/24,Food,Beverages,Lychee Tea,3,6000,18000,0,15000,3000
12/07/24,Food,Beverages,Oolong Tea,1,6000,6000,0,5000,1000
12/07/24,Food,Beverages,Soda,3,5000,15000,0,12000,3000
12/08/24,Food,Food,Takoyaki,3,10000,30000,0,24000,6000
12/08/24,Food,Food,Steak,4,60000,240000,0,220000,20000
12/08/24,Food,Food,Rendang,1,10000,10000,0,8000,2000
12/08/24,Food,Food,Fried Chicken,10,3000,30000,0,20000,10000
12/08/24,Food,Food,Noodles,8,6000,48000,0,40000,8000
12/08/24,Food,Food,Salmon,4,15000,60000,0,56000,4000
12/08/24,Food,Food,Macaroni,1,5000,5000,0,4000,1000
12/08/24,Food,Food,Fish & Chips,3,30000,90000,0,81000,9000
12/08/24,Food,Food,Burger,2,15000,30000,0,28000,2000
12/08/24,Food,Food,Hotdog,3,10000,30000,0,27000,3000
12/08/24,Food,Food,Pasta,1,18000,18000,0,16000,2000
12/08/24,Food,Snack,Chips,2,5000,10000,0,8000,2000
12/08/24,Food,Snack,Popcorn,1,7000,7000,0,6500,500
12/08/24,Food,Snack,Almonds,1,8000,8000,0,7000,1000
12/08/24,Food,Beverages,Lemon Tea,5,4000,20000,0,15000,5000
12/08/24,Food,Beverages,Ocha,2,4000,8000,0,7000,1000
12/08/24,Food,Beverages,Lychee Tea,3,6000,18000,0,15000,3000
12/08/24,Food,Beverages,Oolong Tea,1,6000,6000,0,5000,1000
12/08/24,Food,Beverages,Soda,3,5000,15000,0,12000,3000
12/09/24,Food,Food,Takoyaki,3,10000,30000,0,24000,6000
12/09/24,Food,Food,Steak,4,60000,240000,0,220000,20000
12/09/24,Food,Food,Rendang,1,10000,10000,0,8000,2000
12/09/24,Food,Food,Fried Chicken,10,3000,30000,0,20000,10000
12/09/24,Food,Food,Noodles,8,6000,48000,0,40000,8000
12/09/24,Food,Food,Salmon,4,15000,60000,0,56000,4000
12/09/24,Food,Food,Macaroni,1,5000,5000,0,4000,1000
12/09/24,Food,Food,Fish & Chips,3,30000,90000,0,81000,9000
12/09/24,Food,Food,Burger,2,15000,30000,0,28000,2000
12/09/24,Food,Food,Hotdog,3,10000,30000,0,27000,3000
12/09/24,Food,Food,Pasta,1,18000,18000,0,16000,2000
12/09/24,Food,Snack,Chips,2,5000,10000,0,8000,2000
12/09/24,Food,Snack,Popcorn,1,7000,7000,0,6500,500
12/09/24,Food,Snack,Almonds,1,8000,8000,0,7000,1000
12/09/24,Food,Beverages,Lemon Tea,5,4000,20000,0,15000,5000
12/09/24,Food,Beverages,Ocha,2,4000,8000,0,7000,1000
12/09/24,Food,Beverages,Lychee Tea,3,6000,18000,0,15000,3000
12/09/24,Food,Beverages,Oolong Tea,1,6000,6000,0,5000,1000
12/09/24,Food,Beverages,Soda,3,5000,15000,0,12000,3000
12/10/24,Food,Food,Takoyaki,3,10000,30000,0,24000,6000
12/10/24,Food,Food,Steak,4,60000,240000,0,220000,20000
12/10/24,Food,Food,Rendang,1,10000,10000,0,8000,2000
12/10/24,Food,Food,Fried Chicken,10,3000,30000,0,20000,10000
12/10/24,Food,Food,Noodles,8,6000,48000,0,40000,8000
12/10/24,Food,Food,Salmon,4,15000,60000,0,56000,4000
12/10/24,Food,Food,Macaroni,1,5000,5000,0,4000,1000
12/10/24,Food,Food,Fish & Chips,3,30000,90000,0,81000,9000
12/10/24,Food,Food,Burger,2,15000,30000,0,28000,2000
12/10/24,Food,Food,Hotdog,3,10000,30000,0,27000,3000
12/10/24,Food,Food,Pasta,1,18000,18000,0,16000,2000
12/10/24,Food,Snack,Chips,2,5000,10000,0,8000,2000
12/10/24,Food,Snack,Popcorn,1,7000,7000,0,6500,500
12/10/24,Food,Snack,Almonds,1,8000,8000,0,7000,1000
12/10/24,Food,Beverages,Lemon Tea,5,4000,20000,0,15000,5000
12/10/24,Food,Beverages,Ocha,2,4000,8000,0,7000,1000
12/10/24,Food,Beverages,Lychee Tea,3,6000,18000,0,15000,3000
12/10/24,Food,Beverages,Oolong Tea,1,6000,6000,0,5000,1000
12/10/24,Food,Beverages,Soda,3,5000,15000,0,12000,3000
12/11/24,Food,Food,Takoyaki,3,10000,30000,0,24000,6000
12/11/24,Food,Food,Steak,4,60000,240000,0,220000,20000
12/11/24,Food,Food,Rendang,1,10000,10000,0,8000,2000
12/11/24,Food,Food,Fried Chicken,10,3000,30000,0,20000,10000
12/11/24,Food,Food,Noodles,8,6000,48000,0,40000,8000
12/11/24,Food,Food,Salmon,4,15000,60000,0,56000,4000
12/11/24,Food,Food,Macaroni,1,5000,5000,0,4000,1000
12/11/24,Food,Food,Fish & Chips,3,30000,90000,0,81000,9000
12/11/24,Food,Food,Burger,2,15000,30000,0,28000,2000
12/11/24,Food,Food,Hotdog,3,10000,30000,0,27000,3000
12/11/24,Food,Food,Pasta,1,18000,18000,0,16000,2000
12/11/24,Food,Snack,Chips,2,5000,10000,0,8000,2000
12/11/24,Food,Snack,Popcorn,1,7000,7000,0,6500,500
12/11/24,Food,Snack,Almonds,1,8000,8000,0,7000,1000
12/11/24,Food,Beverages,Lemon Tea,5,4000,20000,0,15000,5000
12/11/24,Food,Beverages,Ocha,2,4000,8000,0,7000,1000
12/11/24,Food,Beverages,Lychee Tea,3,6000,18000,0,15000,3000
12/11/24,Food,Beverages,Oolong Tea,1,6000,6000,0,5000,1000
12/11/24,Food,Beverages,Soda,3,5000,15000,0,12000,3000
12/12/24,Food,Food,Takoyaki,3,10000,30000,0,24000,6000
12/12/24,Food,Food,Steak,4,60000,240000,0,220000,20000
12/12/24,Food,Food,Rendang,1,10000,10000,0,8000,2000
12/12/24,Food,Food,Fried Chicken,10,3000,30000,0,20000,10000
12/12/24,Food,Food,Noodles,8,6000,48000,0,40000,8000
12/12/24,Food,Food,Salmon,4,15000,60000,0,56000,4000
12/12/24,Food,Food,Macaroni,1,5000,5000,0,4000,1000
12/12/24,Food,Food,Fish & Chips,3,30000,90000,0,81000,9000
12/12/24,Food,Food,Burger,2,15000,30000,0,28000,2000
12/12/24,Food,Food,Hotdog,3,10000,30000,0,27000,3000
12/12/24,Food,Food,Pasta,1,18000,18000,0,16000,2000
12/12/24,Food,Snack,Chips,2,5000,10000,0,8000,2000
12/12/24,Food,Snack,Popcorn,1,7000,7000,0,6500,500
12/12/24,Food,Snack,Almonds,1,8000,8000,0,7000,1000
12/12/24,Food,Beverages,Lemon Tea,5,4000,20000,0,15000,5000
12/12/24,Food,Beverages,Ocha,2,4000,8000,0,7000,1000
12/12/24,Food,Beverages,Lychee Tea,3,6000,18000,0,15000,3000
12/12/24,Food,Beverages,Oolong Tea,1,6000,6000,0,5000,1000
12/12/24,Food,Beverages,Soda,3,5000,15000,0,12000,3000
12/13/24,Food,Food,Takoyaki,3,10000,30000,0,24000,6000
12/13/24,Food,Food,Steak,4,60000,240000,0,220000,20000
12/13/24,Food,Food,Rendang,1,10000,10000,0,8000,2000
12/13/24,Food,Food,Fried Chicken,10,3000,30000,0,20000,10000
12/13/24,Food,Food,Noodles,8,6000,48000,0,40000,8000
12/13/24,Food,Food,Salmon,4,15000,60000,0,56000,4000
12/13/24,Food,Food,Macaroni,1,5000,5000,0,4000,1000
12/13/24,Food,Food,Fish & Chips,3,30000,90000,0,81000,9000
12/13/24,Food,Food,Burger,2,15000,30000,0,28000,2000
12/13/24,Food,Food,Hotdog,3,10000,30000,0,27000,3000
12/13/24,Food,Food,Pasta,1,18000,18000,0,16000,2000
12/13/24,Food,Snack,Chips,2,5000,10000,0,8000,2000
12/13/24,Food,Snack,Popcorn,1,7000,7000,0,6500,500
12/13/24,Food,Snack,Almonds,1,8000,8000,0,7000,1000
12/13/24,Food,Beverages,Lemon Tea,5,4000,20000,0,15000,5000
12/13/24,Food,Beverages,Ocha,2,4000,8000,0,7000,1000
12/13/24,Food,Beverages,Lychee Tea,3,6000,18000,0,15000,3000
12/13/24,Food,Beverages,Oolong Tea,1,6000,6000,0,5000,1000
12/13/24,Food,Beverages,Soda,3,5000,15000,0,12000,3000
12/14/24,Food,Food,Takoyaki,3,10000,30000,0,24000,6000
12/14/24,Food,Food,Steak,4,60000,240000,0,220000,20000
12/14/24,Food,Food,Rendang,1,10000,10000,0,8000,2000
12/14/24,Food,Food,Fried Chicken,10,3000,30000,0,20000,10000
12/14/24,Food,Food,Noodles,8,6000,48000,0,40000,8000
12/14/24,Food,Food,Salmon,4,15000,60000,0,56000,4000
12/14/24,Food,Food,Macaroni,1,5000,5000,0,4000,1000
12/14/24,Food,Food,Fish & Chips,3,30000,90000,0,81000,9000
12/14/24,Food,Food,Burger,2,15000,30000,0,28000,2000
12/14/24,Food,Food,Hotdog,3,10000,30000,0,27000,3000
12/14/24,Food,Food,Pasta,1,18000,18000,0,16000,2000
12/14/24,Food,Snack,Chips,2,5000,10000,0,8000,2000
12/14/24,Food,Snack,Popcorn,1,7000,7000,0,6500,500
12/14/24,Food,Snack,Almonds,1,8000,8000,0,7000,1000
12/14/24,Food,Beverages,Lemon Tea,5,4000,20000,0,15000,5000
12/14/24,Food,Beverages,Ocha,2,4000,8000,0,7000,1000
12/14/24,Food,Beverages,Lychee Tea,3,6000,18000,0,15000,3000
12/14/24,Food,Beverages,Oolong Tea,1,6000,6000,0,5000,1000
12/14/24,Food,Beverages,Soda,3,5000,15000,0,12000,3000
12/15/24,Food,Food,Takoyaki,3,10000,30000,0,24000,6000
12/15/24,Food,Food,Steak,4,60000,240000,0,220000,20000
12/15/24,Food,Food,Rendang,1,10000,10000,0,8000,2000
12/15/24,Food,Food,Fried Chicken,10,3000,30000,0,20000,10000
12/15/24,Food,Food,Noodles,8,6000,48000,0,40000,8000
12/15/24,Food,Food,Salmon,4,15000,60000,0,56000,4000
12/15/24,Food,Food,Macaroni,1,5000,5000,0,4000,1000
12/15/24,Food,Food,Fish & Chips,3,30000,90000,0,81000,9000
12/15/24,Food,Food,Burger,2,15000,30000,0,28000,2000
12/15/24,Food,Food,Hotdog,3,10000,30000,0,27000,3000
12/15/24,Food,Food,Pasta,1,18000,18000,0,16000,2000
12/15/24,Food,Snack,Chips,2,5000,10000,0,8000,2000
12/15/24,Food,Snack,Popcorn,1,7000,7000,0,6500,500
12/15/24,Food,Snack,Almonds,1,8000,8000,0,7000,1000
12/15/24,Food,Beverages,Lemon Tea,5,4000,20000,0,15000,5000
12/15/24,Food,Beverages,Ocha,2,4000,8000,0,7000,1000
12/15/24,Food,Beverages,Lychee Tea,3,6000,18000,0,15000,3000
12/15/24,Food,Beverages,Oolong Tea,1,6000,6000,0,5000,1000
12/15/24,Food,Beverages,Soda,3,5000,15000,0,12000,3000
12/16/24,Food,Food,Takoyaki,3,10000,30000,0,24000,6000
12/16/24,Food,Food,Steak,4,60000,240000,0,220000,20000
12/16/24,Food,Food,Rendang,1,10000,10000,0,8000,2000
12/16/24,Food,Food,Fried Chicken,10,3000,30000,0,20000,10000
12/16/24,Food,Food,Noodles,8,6000,48000,0,40000,8000
12/16/24,Food,Food,Salmon,4,15000,60000,0,56000,4000
12/16/24,Food,Food,Macaroni,1,5000,5000,0,4000,1000
12/16/24,Food,Food,Fish & Chips,3,30000,90000,0,81000,9000
12/16/24,Food,Food,Burger,2,15000,30000,0,28000,2000
12/16/24,Food,Food,Hotdog,3,10000,30000,0,27000,3000
12/16/24,Food,Food,Pasta,1,18000,18000,0,16000,2000
12/16/24,Food,Snack,Chips,2,5000,10000,0,8000,2000
12/16/24,Food,Snack,Popcorn,1,7000,7000,0,6500,500
12/16/24,Food,Snack,Almonds,1,8000,8000,0,7000,1000
12/16/24,Food,Beverages,Lemon Tea,5,4000,20000,0,15000,5000
12/16/24,Food,Beverages,Ocha,2,4000,8000,0,7000,1000
12/16/24,Food,Beverages,Lychee Tea,3,6000,18000,0,15000,3000
12/16/24,Food,Beverages,Oolong Tea,1,6000,6000,0,5000,1000
12/16/24,Food,Beverages,Soda,3,5000,15000,0,12000,3000
12/17/24,Food,Food,Takoyaki,3,10000,30000,0,24000,6000
12/17/24,Food,Food,Steak,4,60000,240000,0,220000,20000
12/17/24,Food,Food,Rendang,1,10000,10000,0,8000,2000
12/17/24,Food,Food,Fried Chicken,10,3000,30000,0,20000,10000
12/17/24,Food,Food,Noodles,8,6000,48000,0,40000,8000
12/17/24,Food,Food,Salmon,4,15000,60000,0,56000,4000
12/17/24,Food,Food,Macaroni,1,5000,5000,0,4000,1000
12/17/24,Food,Food,Fish & Chips,3,30000,90000,0,81000,9000
12/17/24,Food,Food,Burger,2,15000,30000,0,28000,2000
12/17/24,Food,Food,Hotdog,3,10000,30000,0,27000,3000
12/17/24,Food,Food,Pasta,1,18000,18000,0,16000,2000
12/17/24,Food,Snack,Chips,2,5000,10000,0,8000,2000
12/17/24,Food,Snack,Popcorn,1,7000,7000,0,6500,500
12/17/24,Food,Snack,Almonds,1,8000,8000,0,7000,1000
12/17/24,Food,Beverages,Lemon Tea,5,4000,20000,0,15000,5000
12/17/24,Food,Beverages,Ocha,2,4000,8000,0,7000,1000
12/17/24,Food,Beverages,Lychee Tea,3,6000,18000,0,15000,3000
12/17/24,Food,Beverages,Oolong Tea,1,6000,6000,0,5000,1000
12/17/24,Food,Beverages,Soda,3,5000,15000,0,12000,3000
12/18/24,Food,Food,Takoyaki,3,10000,30000,0,24000,6000
12/18/24,Food,Food,Steak,4,60000,240000,0,220000,20000
12/18/24,Food,Food,Rendang,1,10000,10000,0,8000,2000
12/18/24,Food,Food,Fried Chicken,10,3000,30000,0,20000,10000
12/18/24,Food,Food,Noodles,8,6000,48000,0,40000,8000
12/18/24,Food,Food,Salmon,4,15000,60000,0,56000,4000
12/18/24,Food,Food,Macaroni,1,5000,5000,0,4000,1000
12/18/24,Food,Food,Fish & Chips,3,30000,90000,0,81000,9000
12/18/24,Food,Food,Burger,2,15000,30000,0,28000,2000
12/18/24,Food,Food,Hotdog,3,10000,30000,0,27000,3000
12/18/24,Food,Food,Pasta,1,18000,18000,0,16000,2000
12/18/24,Food,Snack,Chips,2,5000,10000,0,8000,2000
12/18/24,Food,Snack,Popcorn,1,7000,7000,0,6500,500
12/18/24,Food,Snack,Almonds,1,8000,8000,0,7000,1000
12/18/24,Food,Beverages,Lemon Tea,5,4000,20000,0,15000,5000
12/18/24,Food,Beverages,Ocha,2,4000,8000,0,7000,1000
12/18/24,Food,Beverages,Lychee Tea,3,6000,18000,0,15000,3000
12/18/24,Food,Beverages,Oolong Tea,1,6000,6000,0,5000,1000
12/18/24,Food,Beverages,Soda,3,5000,15000,0,12000,3000
12/19/24,Food,Food,Takoyaki,3,10000,30000,0,24000,6000
12/19/24,Food,Food,Steak,4,60000,240000,0,220000,20000
12/19/24,Food,Food,Rendang,1,10000,10000,0,8000,2000
12/19/24,Food,Food,Fried Chicken,10,3000,30000,0,20000,10000
12/19/24,Food,Food,Noodles,8,6000,48000,0,40000,8000
12/19/24,Food,Food,Salmon,4,15000,60000,0,56000,4000
12/19/24,Food,Food,Macaroni,1,5000,5000,0,4000,1000
12/19/24,Food,Food,Fish & Chips,3,30000,90000,0,81000,9000
12/19/24,Food,Food,Burger,2,15000,30000,0,28000,2000
12/19/24,Food,Food,Hotdog,3,10000,30000,0,27000,3000
12/19/24,Food,Food,Pasta,1,18000,18000,0,16000,2000
12/19/24,Food,Snack,Chips,2,5000,10000,0,8000,2000
12/19/24,Food,Snack,Popcorn,1,7000,7000,0,6500,500
12/19/24,Food,Snack,Almonds,1,8000,8000,0,7000,1000
12/19/24,Food,Beverages,Lemon Tea,5,4000,20000,0,15000,5000
12/19/24,Food,Beverages,Ocha,2,4000,8000,0,7000,1000
12/19/24,Food,Beverages,Lychee Tea,3,6000,18000,0,15000,3000
12/19/24,Food,Beverages,Oolong Tea,1,6000,6000,0,5000,1000
12/19/24,Food,Beverages,Soda,3,5000,15000,0,12000,3000
12/20/24,Food,Food,Takoyaki,3,10000,30000,0,24000,6000
12/20/24,Food,Food,Steak,4,60000,240000,0,220000,20000
12/20/24,Food,Food,Rendang,1,10000,10000,0,8000,2000
12/20/24,Food,Food,Fried Chicken,10,3000,30000,0,20000,10000
12/20/24,Food,Food,Noodles,8,6000,48000,0,40000,8000
12/20/24,Food,Food,Salmon,4,15000,60000,0,56000,4000
12/20/24,Food,Food,Macaroni,1,5000,5000,0,4000,1000
12/20/24,Food,Food,Fish & Chips,3,30000,90000,0,81000,9000
12/20/24,Food,Food,Burger,2,15000,30000,0,28000,2000
12/20/24,Food,Food,Hotdog,3,10000,30000,0,27000,3000
12/20/24,Food,Food,Pasta,1,18000,18000,0,16000,2000
12/20/24,Food,Snack,Chips,2,5000,10000,0,8000,2000
12/20/24,Food,Snack,Popcorn,1,7000,7000,0,6500,500
12/20/24,Food,Snack,Almonds,1,8000,8000,0,7000,1000
12/20/24,Food,Beverages,Lemon Tea,5,4000,20000,0,15000,5000
12/20/24,Food,Beverages,Ocha,2,4000,8000,0,7000,1000
12/20/24,Food,Beverages,Lychee Tea,3,6000,18000,0,15000,3000
12/20/24,Food,Beverages,Oolong Tea,1,6000,6000,0,5000,1000
12/20/24,Food,Beverages,Soda,3,5000,15000,0,12000,3000
12/21/24,Food,Food,Takoyaki,3,10000,30000,0,24000,6000
12/21/24,Food,Food,Steak,4,60000,240000,0,220000,20000
12/21/24,Food,Food,Rendang,1,10000,10000,0,8000,2000
12/21/24,Food,Food,Fried Chicken,10,3000,30000,0,20000,10000
12/21/24,Food,Food,Noodles,8,6000,48000,0,40000,8000
12/21/24,Food,Food,Salmon,4,15000,60000,0,56000,4000
12/21/24,Food,Food,Macaroni,1,5000,5000,0,4000,1000
12/21/24,Food,Food,Fish & Chips,3,30000,90000,0,81000,9000
12/21/24,Food,Food,Burger,2,15000,30000,0,28000,2000
12/21/24,Food,Food,Hotdog,3,10000,30000,0,27000,3000
12/21/24,Food,Food,Pasta,1,18000,18000,0,16000,2000
12/21/24,Food,Snack,Chips,2,5000,10000,0,8000,2000
12/21/24,Food,Snack,Popcorn,1,7000,7000,0,6500,500
12/21/24,Food,Snack,Almonds,1,8000,8000,0,7000,1000
12/21/24,Food,Beverages,Lemon Tea,5,4000,20000,0,15000,5000
12/21/24,Food,Beverages,Ocha,2,4000,8000,0,7000,1000
12/21/24,Food,Beverages,Lychee Tea,3,6000,18000,0,15000,3000
12/21/24,Food,Beverages,Oolong Tea,1,6000,6000,0,5000,1000
12/21/24,Food,Beverages,Soda,3,5000,15000,0,12000,3000
12/22/24,Food,Food,Takoyaki,3,10000,30000,0,24000,6000
12/22/24,Food,Food,Steak,4,60000,240000,0,220000,20000
12/22/24,Food,Food,Rendang,1,10000,10000,0,8000,2000
12/22/24,Food,Food,Fried Chicken,10,3000,30000,0,20000,10000
12/22/24,Food,Food,Noodles,8,6000,48000,0,40000,8000
12/22/24,Food,Food,Salmon,4,15000,60000,0,56000,4000
12/22/24,Food,Food,Macaroni,1,5000,5000,0,4000,1000
12/22/24,Food,Food,Fish & Chips,3,30000,90000,0,81000,9000
12/22/24,Food,Food,Burger,2,15000,30000,0,28000,2000
12/22/24,Food,Food,Hotdog,3,10000,30000,0,27000,3000
12/22/24,Food,Food,Pasta,1,18000,18000,0,16000,2000
12/22/24,Food,Snack,Chips,2,5000,10000,0,8000,2000
12/22/24,Food,Snack,Popcorn,1,7000,7000,0,6500,500
12/22/24,Food,Snack,Almonds,1,8000,8000,0,7000,1000
12/22/24,Food,Beverages,Lemon Tea,5,4000,20000,0,15000,5000
12/22/24,Food,Beverages,Ocha,2,4000,8000,0,7000,1000
12/22/24,Food,Beverages,Lychee Tea,3,6000,18000,0,15000,3000
12/22/24,Food,Beverages,Oolong Tea,1,6000,6000,0,5000,1000
12/22/24,Food,Beverages,Soda,3,5000,15000,0,12000,3000
12/23/24,Food,Food,Takoyaki,3,10000,30000,0,24000,6000
12/23/24,Food,Food,Steak,4,60000,240000,0,220000,20000
12/23/24,Food,Food,Rendang,1,10000,10000,0,8000,2000
12/23/24,Food,Food,Fried Chicken,10,3000,30000,0,20000,10000
12/23/24,Food,Food,Noodles,8,6000,48000,0,40000,8000
12/23/24,Food,Food,Salmon,4,15000,60000,0,56000,4000
12/23/24,Food,Food,Macaroni,1,5000,5000,0,4000,1000
12/23/24,Food,Food,Fish & Chips,3,30000,90000,0,81000,9000
12/23/24,Food,Food,Burger,2,15000,30000,0,28000,2000
12/23/24,Food,Food,Hotdog,3,10000,30000,0,27000,3000
12/23/24,Food,Food,Pasta,1,18000,18000,0,16000,2000
12/23/24,Food,Snack,Chips,2,5000,10000,0,8000,2000
12/23/24,Food,Snack,Popcorn,1,7000,7000,0,6500,500
12/23/24,Food,Snack,Almonds,1,8000,8000,0,7000,1000
12/23/24,Food,Beverages,Lemon Tea,5,4000,20000,0,15000,5000
12/23/24,Food,Beverages,Ocha,2,4000,8000,0,7000,1000
12/23/24,Food,Beverages,Lychee Tea,3,6000,18000,0,15000,3000
12/23/24,Food,Beverages,Oolong Tea,1,6000,6000,0,5000,1000
12/23/24,Food,Beverages,Soda,3,5000,15000,0,12000,3000
12/24/24,Food,Food,Takoyaki,3,10000,30000,0,24000,6000
12/24/24,Food,Food,Steak,4,60000,240000,0,220000,20000
12/24/24,Food,Food,Rendang,1,10000,10000,0,8000,2000
12/24/24,Food,Food,Fried Chicken,10,3000,30000,0,20000,10000
12/24/24,Food,Food,Noodles,8,6000,48000,0,40000,8000
12/24/24,Food,Food,Salmon,4,15000,60000,0,56000,4000
12/24/24,Food,Food,Macaroni,1,5000,5000,0,4000,1000
12/24/24,Food,Food,Fish & Chips,3,30000,90000,0,81000,9000
12/24/24,Food,Food,Burger,2,15000,30000,0,28000,2000
12/24/24,Food,Food,Hotdog,3,10000,30000,0,27000,3000
12/24/24,Food,Food,Pasta,1,18000,18000,0,16000,2000
12/24/24,Food,Snack,Chips,2,5000,10000,0,8000,2000
12/24/24,Food,Snack,Popcorn,1,7000,7000,0,6500,500
12/24/24,Food,Snack,Almonds,1,8000,8000,0,7000,1000
12/24/24,Food,Beverages,Lemon Tea,5,4000,20000,0,15000,5000
12/24/24,Food,Beverages,Ocha,2,4000,8000,0,7000,1000
12/24/24,Food,Beverages,Lychee Tea,3,6000,18000,0,15000,3000
12/24/24,Food,Beverages,Oolong Tea,1,6000,6000,0,5000,1000
12/24/24,Food,Beverages,Soda,3,5000,15000,0,12000,3000
12/25/24,Food,Food,Takoyaki,3,10000,30000,0,24000,6000
12/25/24,Food,Food,Steak,4,60000,240000,0,220000,20000
12/25/24,Food,Food,Rendang,1,10000,10000,0,8000,2000
12/25/24,Food,Food,Fried Chicken,10,3000,30000,0,20000,10000
12/25/24,Food,Food,Noodles,8,6000,48000,0,40000,8000
12/25/24,Food,Food,Salmon,4,15000,60000,0,56000,4000
12/25/24,Food,Food,Macaroni,1,5000,5000,0,4000,1000
12/25/24,Food,Food,Fish & Chips,3,30000,90000,0,81000,9000
12/25/24,Food,Food,Burger,2,15000,30000,0,28000,2000
12/25/24,Food,Food,Hotdog,3,10000,30000,0,27000,3000
12/25/24,Food,Food,Pasta,1,18000,18000,0,16000,2000
12/25/24,Food,Snack,Chips,2,5000,10000,0,8000,2000
12/25/24,Food,Snack,Popcorn,1,7000,7000,0,6500,500
12/25/24,Food,Snack,Almonds,1,8000,8000,0,7000,1000
12/25/24,Food,Beverages,Lemon Tea,5,4000,20000,0,15000,5000
12/25/24,Food,Beverages,Ocha,2,4000,8000,0,7000,1000
12/25/24,Food,Beverages,Lychee Tea,3,6000,18000,0,15000,3000
12/25/24,Food,Beverages,Oolong Tea,1,6000,6000,0,5000,1000
12/25/24,Food,Beverages,Soda,3,5000,15000,0,12000,3000
12/26/24,Food,Food,Takoyaki,3,10000,30000,0,24000,6000
12/26/24,Food,Food,Steak,4,60000,240000,0,220000,20000
12/26/24,Food,Food,Rendang,1,10000,10000,0,8000,2000
12/26/24,Food,Food,Fried Chicken,10,3000,30000,0,20000,10000
12/26/24,Food,Food,Noodles,8,6000,48000,0,40000,8000
12/26/24,Food,Food,Salmon,4,15000,60000,0,56000,4000
12/26/24,Food,Food,Macaroni,1,5000,5000,0,4000,1000
12/26/24,Food,Food,Fish & Chips,3,30000,90000,0,81000,9000
12/26/24,Food,Food,Burger,2,15000,30000,0,28000,2000
12/26/24,Food,Food,Hotdog,3,10000,30000,0,27000,3000
12/26/24,Food,Food,Pasta,1,18000,18000,0,16000,2000
12/26/24,Food,Snack,Chips,2,5000,10000,0,8000,2000
12/26/24,Food,Snack,Popcorn,1,7000,7000,0,6500,500
12/26/24,Food,Snack,Almonds,1,8000,8000,0,7000,1000
12/26/24,Food,Beverages,Lemon Tea,5,4000,20000,0,15000,5000
12/26/24,Food,Beverages,Ocha,2,4000,8000,0,7000,1000
12/26/24,Food,Beverages,Lychee Tea,3,6000,18000,0,15000,3000
12/26/24,Food,Beverages,Oolong Tea,1,6000,6000,0,5000,1000
12/26/24,Food,Beverages,Soda,3,5000,15000,0,12000,3000
12/27/24,Food,Food,Takoyaki,3,10000,30000,0,24000,6000
12/27/24,Food,Food,Steak,4,60000,240000,0,220000,20000
12/27/24,Food,Food,Rendang,1,10000,10000,0,8000,2000
12/27/24,Food,Food,Fried Chicken,10,3000,30000,0,20000,10000
12/27/24,Food,Food,Noodles,8,6000,48000,0,40000,8000
12/27/24,Food,Food,Salmon,4,15000,60000,0,56000,4000
12/27/24,Food,Food,Macaroni,1,5000,5000,0,4000,1000
12/27/24,Food,Food,Fish & Chips,3,30000,90000,0,81000,9000
12/27/24,Food,Food,Burger,2,15000,30000,0,28000,2000
12/27/24,Food,Food,Hotdog,3,10000,30000,0,27000,3000
12/27/24,Food,Food,Pasta,1,18000,18000,0,16000,2000
12/27/24,Food,Snack,Chips,2,5000,10000,0,8000,2000
12/27/24,Food,Snack,Popcorn,1,7000,7000,0,6500,500
12/27/24,Food,Snack,Almonds,1,8000,8000,0,7000,1000
12/27/24,Food,Beverages,Lemon Tea,5,4000,20000,0,15000,5000
12/27/24,Food,Beverages,Ocha,2,4000,8000,0,7000,1000
12/27/24,Food,Beverages,Lychee Tea,3,6000,18000,0,15000,3000
12/27/24,Food,Beverages,Oolong Tea,1,6000,6000,0,5000,1000
12/27/24,Food,Beverages,Soda,3,5000,15000,0,12000,3000
12/28/24,Food,Food,Takoyaki,3,10000,30000,0,24000,6000
12/28/24,Food,Food,Steak,4,60000,240000,0,220000,20000
12/28/24,Food,Food,Rendang,1,10000,10000,0,8000,2000
12/28/24,Food,Food,Fried Chicken,10,3000,30000,0,20000,10000
12/28/24,Food,Food,Noodles,8,6000,48000,0,40000,8000
12/28/24,Food,Food,Salmon,4,15000,60000,0,56000,4000
12/28/24,Food,Food,Macaroni,1,5000,5000,0,4000,1000
12/28/24,Food,Food,Fish & Chips,3,30000,90000,0,81000,9000
12/28/24,Food,Food,Burger,2,15000,30000,0,28000,2000
12/28/24,Food,Food,Hotdog,3,10000,30000,0,27000,3000
12/28/24,Food,Food,Pasta,1,18000,18000,0,16000,2000
12/28/24,Food,Snack,Chips,2,5000,10000,0,8000,2000
12/28/24,Food,Snack,Popcorn,1,7000,7000,0,6500,500
12/28/24,Food,Snack,Almonds,1,8000,8000,0,7000,1000
12/28/24,Food,Beverages,Lemon Tea,5,4000,20000,0,15000,5000
12/28/24,Food,Beverages,Ocha,2,4000,8000,0,7000,1000
12/28/24,Food,Beverages,Lychee Tea,3,6000,18000,0,15000,3000
12/28/24,Food,Beverages,Oolong Tea,1,6000,6000,0,5000,1000
12/28/24,Food,Beverages,Soda,3,5000,15000,0,12000,3000
12/29/24,Food,Food,Takoyaki,3,10000,30000,0,24000,6000
12/29/24,Food,Food,Steak,4,60000,240000,0,220000,20000
12/29/24,Food,Food,Rendang,1,10000,10000,0,8000,2000
12/29/24,Food,Food,Fried Chicken,10,3000,30000,0,20000,10000
12/29/24,Food,Food,Noodles,8,6000,48000,0,40000,8000
12/29/24,Food,Food,Salmon,4,15000,60000,0,56000,4000
12/29/24,Food,Food,Macaroni,1,5000,5000,0,4000,1000
12/29/24,Food,Food,Fish & Chips,3,30000,90000,0,81000,9000
12/29/24,Food,Food,Burger,2,15000,30000,0,28000,2000
12/29/24,Food,Food,Hotdog,3,10000,30000,0,27000,3000
12/29/24,Food,Food,Pasta,1,18000,18000,0,16000,2000
12/29/24,Food,Snack,Chips,2,5000,10000,0,8000,2000
12/29/24,Food,Snack,Popcorn,1,7000,7000,0,6500,500
12/29/24,Food,Snack,Almonds,1,8000,8000,0,7000,1000
12/29/24,Food,Beverages,Lemon Tea,5,4000,20000,0,15000,5000
12/29/24,Food,Beverages,Ocha,2,4000,8000,0,7000,1000
12/29/24,Food,Beverages,Lychee Tea,3,6000,18000,0,15000,3000
12/29/24,Food,Beverages,Oolong Tea,1,6000,6000,0,5000,1000
12/29/24,Food,Beverages,Soda,3,5000,15000,0,12000,3000
12/30/24,Food,Food,Takoyaki,3,10000,30000,0,24000,6000
12/30/24,Food,Food,Steak,4,60000,240000,0,220000,20000
12/30/24,Food,Food,Rendang,1,10000,10000,0,8000,2000
12/30/24,Food,Food,Fried Chicken,10,3000,30000,0,20000,10000
12/30/24,Food,Food,Noodles,8,6000,48000,0,40000,8000
12/30/24,Food,Food,Salmon,4,15000,60000,0,56000,4000
12/30/24,Food,Food,Macaroni,1,5000,5000,0,4000,1000
12/30/24,Food,Food,Fish & Chips,3,30000,90000,0,81000,9000
12/30/24,Food,Food,Burger,2,15000,30000,0,28000,2000
12/30/24,Food,Food,Hotdog,3,10000,30000,0,27000,3000
12/30/24,Food,Food,Pasta,1,18000,18000,0,16000,2000
12/30/24,Food,Snack,Chips,2,5000,10000,0,8000,2000
12/30/24,Food,Snack,Popcorn,1,7000,7000,0,6500,500
12/30/24,Food,Snack,Almonds,1,8000,8000,0,7000,1000
12/30/24,Food,Beverages,Lemon Tea,5,4000,20000,0,15000,5000
12/30/24,Food,Beverages,Ocha,2,4000,8000,0,7000,1000
12/30/24,Food,Beverages,Lychee Tea,3,6000,18000,0,15000,3000
12/30/24,Food,Beverages,Oolong Tea,1,6000,6000,0,5000,1000
12/30/24,Food,Beverages,Soda,3,5000,15000,0,12000,3000
12/31/24,Food,Food,Takoyaki,3,10000,30000,0,24000,6000
12/31/24,Food,Food,Steak,4,60000,240000,0,220000,20000
12/31/24,Food,Food,Rendang,1,10000,10000,0,8000,2000
12/31/24,Food,Food,Fried Chicken,10,3000,30000,0,20000,10000
12/31/24,Food,Food,Noodles,8,6000,48000,0,40000,8000
12/31/24,Food,Food,Salmon,4,15000,60000,0,56000,4000
12/31/24,Food,Food,Macaroni,1,5000,5000,0,4000,1000
12/31/24,Food,Food,Fish & Chips,3,30000,90000,0,81000,9000
12/31/24,Food,Food,Burger,2,15000,30000,0,28000,2000
12/31/24,Food,Food,Hotdog,3,10000,30000,0,27000,3000
12/31/24,Food,Food,Pasta,1,18000,18000,0,16000,2000
12/31/24,Food,Snack,Chips,2,5000,10000,0,8000,2000
12/31/24,Food,Snack,Popcorn,1,7000,7000,0,6500,500
12/31/24,Food,Snack,Almonds,1,8000,8000,0,7000,1000
12/31/24,Food,Beverages,Lemon Tea,5,4000,20000,0,15000,5000
12/31/24,Food,Beverages,Ocha,2,4000,8000,0,7000,1000
12/31/24,Food,Beverages,Lychee Tea,3,6000,18000,0,15000,3000
12/31/24,Food,Beverages,Oolong Tea,1,6000,6000,0,5000,1000
12/31/24,Food,Beverages,Soda,3,5000,15000,0,12000,3000
01/01/25,Food,Food,Takoyaki,3,10000,30000,0,24000,6000
01/01/25,Food,Food,Steak,4,60000,240000,0,220000,20000
01/01/25,Food,Food,Rendang,1,10000,10000,0,8000,2000
01/01/25,Food,Food,Fried Chicken,10,3000,30000,0,20000,10000
01/01/25,Food,Food,Noodles,8,6000,48000,0,40000,8000
01/01/25,Food,Food,Salmon,4,15000,60000,0,56000,4000
01/01/25,Food,Food,Macaroni,1,5000,5000,0,4000,1000
01/01/25,Food,Food,Fish & Chips,3,30000,90000,0,81000,9000
01/01/25,Food,Food,Burger,2,15000,30000,0,28000,2000
01/01/25,Food,Food,Hotdog,3,10000,30000,0,27000,3000
01/01/25,Food,Food,Pasta,1,18000,18000,0,16000,2000
01/01/25,Food,Snack,Chips,2,5000,10000,0,8000,2000
01/01/25,Food,Snack,Popcorn,1,7000,7000,0,6500,500
01/01/25,Food,Snack,Almonds,1,8000,8000,0,7000,1000
01/01/25,Food,Beverages,Lemon Tea,5,4000,20000,0,15000,5000
01/01/25,Food,Beverages,Ocha,2,4000,8000,0,7000,1000
01/01/25,Food,Beverages,Lychee Tea,3,6000,18000,0,15000,3000
01/01/25,Food,Beverages,Oolong Tea,1,6000,6000,0,5000,1000
01/01/25,Food,Beverages,Soda,3,5000,15000,0,12000,3000
01/02/25,Food,Food,Takoyaki,3,10000,30000,0,24000,6000
01/02/25,Food,Food,Steak,4,60000,240000,0,220000,20000
01/02/25,Food,Food,Rendang,1,10000,10000,0,8000,2000
01/02/25,Food,Food,Fried Chicken,10,3000,30000,0,20000,10000
01/02/25,Food,Food,Noodles,8,6000,48000,0,40000,8000
01/02/25,Food,Food,Salmon,4,15000,60000,0,56000,4000
01/02/25,Food,Food,Macaroni,1,5000,5000,0,4000,1000
01/02/25,Food,Food,Fish & Chips,3,30000,90000,0,81000,9000
01/02/25,Food,Food,Burger,2,15000,30000,0,28000,2000
01/02/25,Food,Food,Hotdog,3,10000,30000,0,27000,3000
01/02/25,Food,Food,Pasta,1,18000,18000,0,16000,2000
01/02/25,Food,Snack,Chips,2,5000,10000,0,8000,2000
01/02/25,Food,Snack,Popcorn,1,7000,7000,0,6500,500
01/02/25,Food,Snack,Almonds,1,8000,8000,0,7000,1000
01/02/25,Food,Beverages,Lemon Tea,5,4000,20000,0,15000,5000
01/02/25,Food,Beverages,Ocha,2,4000,8000,0,7000,1000
01/02/25,Food,Beverages,Lychee Tea,3,6000,18000,0,15000,3000
01/02/25,Food,Beverages,Oolong Tea,1,6000,6000,0,5000,1000
01/02/25,Food,Beverages,Soda,3,5000,15000,0,12000,3000
01/03/25,Food,Food,Takoyaki,3,10000,30000,0,24000,6000
01/03/25,Food,Food,Steak,4,60000,240000,0,220000,20000
01/03/25,Food,Food,Rendang,1,10000,10000,0,8000,2000
01/03/25,Food,Food,Fried Chicken,10,3000,30000,0,20000,10000
01/03/25,Food,Food,Noodles,8,6000,48000,0,40000,8000
01/03/25,Food,Food,Salmon,4,15000,60000,0,56000,4000
01/03/25,Food,Food,Macaroni,1,5000,5000,0,4000,1000
01/03/25,Food,Food,Fish & Chips,3,30000,90000,0,81000,9000
01/03/25,Food,Food,Burger,2,15000,30000,0,28000,2000
01/03/25,Food,Food,Hotdog,3,10000,30000,0,27000,3000
01/03/25,Food,Food,Pasta,1,18000,18000,0,16000,2000
01/03/25,Food,Snack,Chips,2,5000,10000,0,8000,2000
01/03/25,Food,Snack,Popcorn,1,7000,7000,0,6500,500
01/03/25,Food,Snack,Almonds,1,8000,8000,0,7000,1000
01/03/25,Food,Beverages,Lemon Tea,5,4000,20000,0,15000,5000
01/03/25,Food,Beverages,Ocha,2,4000,8000,0,7000,1000
01/03/25,Food,Beverages,Lychee Tea,3,6000,18000,0,15000,3000
01/03/25,Food,Beverages,Oolong Tea,1,6000,6000,0,5000,1000
01/03/25,Food,Beverages,Soda,3,5000,15000,0,12000,3000
01/04/25,Food,Food,Takoyaki,3,10000,30000,0,24000,6000
01/04/25,Food,Food,Steak,4,60000,240000,0,220000,20000
01/04/25,Food,Food,Rendang,1,10000,10000,0,8000,2000
01/04/25,Food,Food,Fried Chicken,10,3000,30000,0,20000,10000
01/04/25,Food,Food,Noodles,8,6000,48000,0,40000,8000
01/04/25,Food,Food,Salmon,4,15000,60000,0,56000,4000
01/04/25,Food,Food,Macaroni,1,5000,5000,0,4000,1000
01/04/25,Food,Food,Fish & Chips,3,30000,90000,0,81000,9000
01/04/25,Food,Food,Burger,2,15000,30000,0,28000,2000
01/04/25,Food,Food,Hotdog,3,10000,30000,0,27000,3000
01/04/25,Food,Food,Pasta,1,18000,18000,0,16000,2000
01/04/25,Food,Snack,Chips,2,5000,10000,0,8000,2000
01/04/25,Food,Snack,Popcorn,1,7000,7000,0,6500,500
01/04/25,Food,Snack,Almonds,1,8000,8000,0,7000,1000
01/04/25,Food,Beverages,Lemon Tea,5,4000,20000,0,15000,5000
01/04/25,Food,Beverages,Ocha,2,4000,8000,0,7000,1000
01/04/25,Food,Beverages,Lychee Tea,3,6000,18000,0,15000,3000
01/04/25,Food,Beverages,Oolong Tea,1,6000,6000,0,5000,1000
01/04/25,Food,Beverages,Soda,3,5000,15000,0,12000,3000
01/05/25,Food,Food,Takoyaki,3,10000,30000,0,24000,6000
01/05/25,Food,Food,Steak,4,60000,240000,0,220000,20000
01/05/25,Food,Food,Rendang,1,10000,10000,0,8000,2000
01/05/25,Food,Food,Fried Chicken,10,3000,30000,0,20000,10000
01/05/25,Food,Food,Noodles,8,6000,48000,0,40000,8000
01/05/25,Food,Food,Salmon,4,15000,60000,0,56000,4000
01/05/25,Food,Food,Macaroni,1,5000,5000,0,4000,1000
01/05/25,Food,Food,Fish & Chips,3,30000,90000,0,81000,9000
01/05/25,Food,Food,Burger,2,15000,30000,0,28000,2000
01/05/25,Food,Food,Hotdog,3,10000,30000,0,27000,3000
01/05/25,Food,Food,Pasta,1,18000,18000,0,16000,2000
01/05/25,Food,Snack,Chips,2,5000,10000,0,8000,2000
01/05/25,Food,Snack,Popcorn,1,7000,7000,0,6500,500
01/05/25,Food,Snack,Almonds,1,8000,8000,0,7000,1000
01/05/25,Food,Beverages,Lemon Tea,5,4000,20000,0,15000,5000
01/05/25,Food,Beverages,Ocha,2,4000,8000,0,7000,1000
01/05/25,Food,Beverages,Lychee Tea,3,6000,18000,0,15000,3000
01/05/25,Food,Beverages,Oolong Tea,1,6000,6000,0,5000,1000
01/05/25,Food,Beverages,Soda,3,5000,15000,0,12000,3000
01/06/25,Food,Food,Takoyaki,3,10000,30000,0,24000,6000
01/06/25,Food,Food,Steak,4,60000,240000,0,220000,20000
01/06/25,Food,Food,Rendang,1,10000,10000,0,8000,2000
01/06/25,Food,Food,Fried Chicken,10,3000,30000,0,20000,10000
01/06/25,Food,Food,Noodles,8,6000,48000,0,40000,8000
01/06/25,Food,Food,Salmon,4,15000,60000,0,56000,4000
01/06/25,Food,Food,Macaroni,1,5000,5000,0,4000,1000
01/06/25,Food,Food,Fish & Chips,3,30000,90000,0,81000,9000
01/06/25,Food,Food,Burger,2,15000,30000,0,28000,2000
01/06/25,Food,Food,Hotdog,3,10000,30000,0,27000,3000
01/06/25,Food,Food,Pasta,1,18000,18000,0,16000,2000
01/06/25,Food,Snack,Chips,2,5000,10000,0,8000,2000
01/06/25,Food,Snack,Popcorn,1,7000,7000,0,6500,500
01/06/25,Food,Snack,Almonds,1,8000,8000,0,7000,1000
01/06/25,Food,Beverages,Lemon Tea,5,4000,20000,0,15000,5000
01/06/25,Food,Beverages,Ocha,2,4000,8000,0,7000,1000
01/06/25,Food,Beverages,Lychee Tea,3,6000,18000,0,15000,3000
01/06/25,Food,Beverages,Oolong Tea,1,6000,6000,0,5000,1000
01/06/25,Food,Beverages,Soda,3,5000,15000,0,12000,3000
01/07/25,Food,Food,Takoyaki,3,10000,30000,0,24000,6000
01/07/25,Food,Food,Steak,4,60000,240000,0,220000,20000
01/07/25,Food,Food,Rendang,1,10000,10000,0,8000,2000
01/07/25,Food,Food,Fried Chicken,10,3000,30000,0,20000,10000
01/07/25,Food,Food,Noodles,8,6000,48000,0,40000,8000
01/07/25,Food,Food,Salmon,4,15000,60000,0,56000,4000
01/07/25,Food,Food,Macaroni,1,5000,5000,0,4000,1000
01/07/25,Food,Food,Fish & Chips,3,30000,90000,0,81000,9000
01/07/25,Food,Food,Burger,2,15000,30000,0,28000,2000
01/07/25,Food,Food,Hotdog,3,10000,30000,0,27000,3000
01/07/25,Food,Food,Pasta,1,18000,18000,0,16000,2000
01/07/25,Food,Snack,Chips,2,5000,10000,0,8000,2000
01/07/25,Food,Snack,Popcorn,1,7000,7000,0,6500,500
01/07/25,Food,Snack,Almonds,1,8000,8000,0,7000,1000
01/07/25,Food,Beverages,Lemon Tea,5,4000,20000,0,15000,5000
01/07/25,Food,Beverages,Ocha,2,4000,8000,0,7000,1000
01/07/25,Food,Beverages,Lychee Tea,3,6000,18000,0,15000,3000
01/07/25,Food,Beverages,Oolong Tea,1,6000,6000,0,5000,1000
01/07/25,Food,Beverages,Soda,3,5000,15000,0,12000,3000
01/08/25,Food,Food,Takoyaki,3,10000,30000,0,24000,6000
01/08/25,Food,Food,Steak,4,60000,240000,0,220000,20000
01/08/25,Food,Food,Rendang,1,10000,10000,0,8000,2000
01/08/25,Food,Food,Fried Chicken,10,3000,30000,0,20000,10000
01/08/25,Food,Food,Noodles,8,6000,48000,0,40000,8000
01/08/25,Food,Food,Salmon,4,15000,60000,0,56000,4000
01/08/25,Food,Food,Macaroni,1,5000,5000,0,4000,1000
01/08/25,Food,Food,Fish & Chips,3,30000,90000,0,81000,9000
01/08/25,Food,Food,Burger,2,15000,30000,0,28000,2000
01/08/25,Food,Food,Hotdog,3,10000,30000,0,27000,3000
01/08/25,Food,Food,Pasta,1,18000,18000,0,16000,2000
01/08/25,Food,Snack,Chips,2,5000,10000,0,8000,2000
01/08/25,Food,Snack,Popcorn,1,7000,7000,0,6500,500
01/08/25,Food,Snack,Almonds,1,8000,8000,0,7000,1000
01/08/25,Food,Beverages,Lemon Tea,5,4000,20000,0,15000,5000
01/08/25,Food,Beverages,Ocha,2,4000,8000,0,7000,1000
01/08/25,Food,Beverages,Lychee Tea,3,6000,18000,0,15000,3000
01/08/25,Food,Beverages,Oolong Tea,1,6000,6000,0,5000,1000
01/08/25,Food,Beverages,Soda,3,5000,15000,0,12000,3000
01/09/25,Food,Food,Takoyaki,3,10000,30000,0,24000,6000
01/09/25,Food,Food,Steak,4,60000,240000,0,220000,20000
01/09/25,Food,Food,Rendang,1,10000,10000,0,8000,2000
01/09/25,Food,Food,Fried Chicken,10,3000,30000,0,20000,10000
01/09/25,Food,Food,Noodles,8,6000,48000,0,40000,8000
01/09/25,Food,Food,Salmon,4,15000,60000,0,56000,4000
01/09/25,Food,Food,Macaroni,1,5000,5000,0,4000,1000
01/09/25,Food,Food,Fish & Chips,3,30000,90000,0,81000,9000
01/09/25,Food,Food,Burger,2,15000,30000,0,28000,2000
01/09/25,Food,Food,Hotdog,3,10000,30000,0,27000,3000
01/09/25,Food,Food,Pasta,1,18000,18000,0,16000,2000
01/09/25,Food,Snack,Chips,2,5000,10000,0,8000,2000
01/09/25,Food,Snack,Popcorn,1,7000,7000,0,6500,500
01/09/25,Food,Snack,Almonds,1,8000,8000,0,7000,1000
01/09/25,Food,Beverages,Lemon Tea,5,4000,20000,0,15000,5000
01/09/25,Food,Beverages,Ocha,2,4000,8000,0,7000,1000
01/09/25,Food,Beverages,Lychee Tea,3,6000,18000,0,15000,3000
01/09/25,Food,Beverages,Oolong Tea,1,6000,6000,0,5000,1000
01/09/25,Food,Beverages,Soda,3,5000,15000,0,12000,3000
01/10/25,Food,Food,Takoyaki,3,10000,30000,0,24000,6000
01/10/25,Food,Food,Steak,4,60000,240000,0,220000,20000
01/10/25,Food,Food,Rendang,1,10000,10000,0,8000,2000
01/10/25,Food,Food,Fried Chicken,10,3000,30000,0,20000,10000
01/10/25,Food,Food,Noodles,8,6000,48000,0,40000,8000
01/10/25,Food,Food,Salmon,4,15000,60000,0,56000,4000
01/10/25,Food,Food,Macaroni,1,5000,5000,0,4000,1000
01/10/25,Food,Food,Fish & Chips,3,30000,90000,0,81000,9000
01/10/25,Food,Food,Burger,2,15000,30000,0,28000,2000
01/10/25,Food,Food,Hotdog,3,10000,30000,0,27000,3000
01/10/25,Food,Food,Pasta,1,18000,18000,0,16000,2000
01/10/25,Food,Snack,Chips,2,5000,10000,0,8000,2000
01/10/25,Food,Snack,Popcorn,1,7000,7000,0,6500,500
01/10/25,Food,Snack,Almonds,1,8000,8000,0,7000,1000
01/10/25,Food,Beverages,Lemon Tea,5,4000,20000,0,15000,5000
01/10/25,Food,Beverages,Ocha,2,4000,8000,0,7000,1000
01/10/25,Food,Beverages,Lychee Tea,3,6000,18000,0,15000,3000
01/10/25,Food,Beverages,Oolong Tea,1,6000,6000,0,5000,1000
01/10/25,Food,Beverages,Soda,3,5000,15000,0,12000,3000
01/11/25,Food,Food,Takoyaki,3,10000,30000,0,24000,6000
01/11/25,Food,Food,Steak,4,60000,240000,0,220000,20000
01/11/25,Food,Food,Rendang,1,10000,10000,0,8000,2000
01/11/25,Food,Food,Fried Chicken,10,3000,30000,0,20000,10000
01/11/25,Food,Food,Noodles,8,6000,48000,0,40000,8000
01/11/25,Food,Food,Salmon,4,15000,60000,0,56000,4000
01/11/25,Food,Food,Macaroni,1,5000,5000,0,4000,1000
01/11/25,Food,Food,Fish & Chips,3,30000,90000,0,81000,9000
01/11/25,Food,Food,Burger,2,15000,30000,0,28000,2000
01/11/25,Food,Food,Hotdog,3,10000,30000,0,27000,3000
01/11/25,Food,Food,Pasta,1,18000,18000,0,16000,2000
01/11/25,Food,Snack,Chips,2,5000,10000,0,8000,2000
01/11/25,Food,Snack,Popcorn,1,7000,7000,0,6500,500
01/11/25,Food,Snack,Almonds,1,8000,8000,0,7000,1000
01/11/25,Food,Beverages,Lemon Tea,5,4000,20000,0,15000,5000
01/11/25,Food,Beverages,Ocha,2,4000,8000,0,7000,1000
01/11/25,Food,Beverages,Lychee Tea,3,6000,18000,0,15000,3000
01/11/25,Food,Beverages,Oolong Tea,1,6000,6000,0,5000,1000
01/11/25,Food,Beverages,Soda,3,5000,15000,0,12000,3000
01/12/25,Food,Food,Takoyaki,3,10000,30000,0,24000,6000
01/12/25,Food,Food,Steak,4,60000,240000,0,220000,20000
01/12/25,Food,Food,Rendang,1,10000,10000,0,8000,2000
01/12/25,Food,Food,Fried Chicken,10,3000,30000,0,20000,10000
01/12/25,Food,Food,Noodles,8,6000,48000,0,40000,8000
01/12/25,Food,Food,Salmon,4,15000,60000,0,56000,4000
01/12/25,Food,Food,Macaroni,1,5000,5000,0,4000,1000
01/12/25,Food,Food,Fish & Chips,3,30000,90000,0,81000,9000
01/12/25,Food,Food,Burger,2,15000,30000,0,28000,2000
01/12/25,Food,Food,Hotdog,3,10000,30000,0,27000,3000
01/12/25,Food,Food,Pasta,1,18000,18000,0,16000,2000
01/12/25,Food,Snack,Chips,2,5000,10000,0,8000,2000
01/12/25,Food,Snack,Popcorn,1,7000,7000,0,6500,500
01/12/25,Food,Snack,Almonds,1,8000,8000,0,7000,1000
01/12/25,Food,Beverages,Lemon Tea,5,4000,20000,0,15000,5000
01/12/25,Food,Beverages,Ocha,2,4000,8000,0,7000,1000
01/12/25,Food,Beverages,Lychee Tea,3,6000,18000,0,15000,3000
01/12/25,Food,Beverages,Oolong Tea,1,6000,6000,0,5000,1000
01/12/25,Food,Beverages,Soda,3,5000,15000,0,12000,3000
01/13/25,Food,Food,Takoyaki,3,10000,30000,0,24000,6000
01/13/25,Food,Food,Steak,4,60000,240000,0,220000,20000
01/13/25,Food,Food,Rendang,1,10000,10000,0,8000,2000
01/13/25,Food,Food,Fried Chicken,10,3000,30000,0,20000,10000
01/13/25,Food,Food,Noodles,8,6000,48000,0,40000,8000
01/13/25,Food,Food,Salmon,4,15000,60000,0,56000,4000
01/13/25,Food,Food,Macaroni,1,5000,5000,0,4000,1000
01/13/25,Food,Food,Fish & Chips,3,30000,90000,0,81000,9000
01/13/25,Food,Food,Burger,2,15000,30000,0,28000,2000
01/13/25,Food,Food,Hotdog,3,10000,30000,0,27000,3000
01/13/25,Food,Food,Pasta,1,18000,18000,0,16000,2000
01/13/25,Food,Snack,Chips,2,5000,10000,0,8000,2000
01/13/25,Food,Snack,Popcorn,1,7000,7000,0,6500,500
01/13/25,Food,Snack,Almonds,1,8000,8000,0,7000,1000
01/13/25,Food,Beverages,Lemon Tea,5,4000,20000,0,15000,5000
01/13/25,Food,Beverages,Ocha,2,4000,8000,0,7000,1000
01/13/25,Food,Beverages,Lychee Tea,3,6000,18000,0,15000,3000
01/13/25,Food,Beverages,Oolong Tea,1,6000,6000,0,5000,1000
01/13/25,Food,Beverages,Soda,3,5000,15000,0,12000,3000
01/14/25,Food,Food,Takoyaki,3,10000,30000,0,24000,6000
01/14/25,Food,Food,Steak,4,60000,240000,0,220000,20000
01/14/25,Food,Food,Rendang,1,10000,10000,0,8000,2000
01/14/25,Food,Food,Fried Chicken,10,3000,30000,0,20000,10000
01/14/25,Food,Food,Noodles,8,6000,48000,0,40000,8000
01/14/25,Food,Food,Salmon,4,15000,60000,0,56000,4000
01/14/25,Food,Food,Macaroni,1,5000,5000,0,4000,1000
01/14/25,Food,Food,Fish & Chips,3,30000,90000,0,81000,9000
01/14/25,Food,Food,Burger,2,15000,30000,0,28000,2000
01/14/25,Food,Food,Hotdog,3,10000,30000,0,27000,3000
01/14/25,Food,Food,Pasta,1,18000,18000,0,16000,2000
01/14/25,Food,Snack,Chips,2,5000,10000,0,8000,2000
01/14/25,Food,Snack,Popcorn,1,7000,7000,0,6500,500
01/14/25,Food,Snack,Almonds,1,8000,8000,0,7000,1000
01/14/25,Food,Beverages,Lemon Tea,5,4000,20000,0,15000,5000
01/14/25,Food,Beverages,Ocha,2,4000,8000,0,7000,1000
01/14/25,Food,Beverages,Lychee Tea,3,6000,18000,0,15000,3000
01/14/25,Food,Beverages,Oolong Tea,1,6000,6000,0,5000,1000
01/14/25,Food,Beverages,Soda,3,5000,15000,0,12000,3000
01/15/25,Food,Food,Takoyaki,3,10000,30000,0,24000,6000
01/15/25,Food,Food,Steak,4,60000,240000,0,220000,20000
01/15/25,Food,Food,Rendang,1,10000,10000,0,8000,2000
01/15/25,Food,Food,Fried Chicken,10,3000,30000,0,20000,10000
01/15/25,Food,Food,Noodles,8,6000,48000,0,40000,8000
01/15/25,Food,Food,Salmon,4,15000,60000,0,56000,4000
01/15/25,Food,Food,Macaroni,1,5000,5000,0,4000,1000
01/15/25,Food,Food,Fish & Chips,3,30000,90000,0,81000,9000
01/15/25,Food,Food,Burger,2,15000,30000,0,28000,2000
01/15/25,Food,Food,Hotdog,3,10000,30000,0,27000,3000
01/15/25,Food,Food,Pasta,1,18000,18000,0,16000,2000
01/15/25,Food,Snack,Chips,2,5000,10000,0,8000,2000
01/15/25,Food,Snack,Popcorn,1,7000,7000,0,6500,500
01/15/25,Food,Snack,Almonds,1,8000,8000,0,7000,1000
01/15/25,Food,Beverages,Lemon Tea,5,4000,20000,0,15000,5000
01/15/25,Food,Beverages,Ocha,2,4000,8000,0,7000,1000
01/15/25,Food,Beverages,Lychee Tea,3,6000,18000,0,15000,3000
01/15/25,Food,Beverages,Oolong Tea,1,6000,6000,0,5000,1000
01/15/25,Food,Beverages,Soda,3,5000,15000,0,12000,3000
01/16/25,Food,Food,Takoyaki,3,10000,30000,0,24000,6000
01/16/25,Food,Food,Steak,4,60000,240000,0,220000,20000
01/16/25,Food,Food,Rendang,1,10000,10000,0,8000,2000
01/16/25,Food,Food,Fried Chicken,10,3000,30000,0,20000,10000
01/16/25,Food,Food,Noodles,8,6000,48000,0,40000,8000
01/16/25,Food,Food,Salmon,4,15000,60000,0,56000,4000
01/16/25,Food,Food,Macaroni,1,5000,5000,0,4000,1000
01/16/25,Food,Food,Fish & Chips,3,30000,90000,0,81000,9000
01/16/25,Food,Food,Burger,2,15000,30000,0,28000,2000
01/16/25,Food,Food,Hotdog,3,10000,30000,0,27000,3000
01/16/25,Food,Food,Pasta,1,18000,18000,0,16000,2000
01/16/25,Food,Snack,Chips,2,5000,10000,0,8000,2000
01/16/25,Food,Snack,Popcorn,1,7000,7000,0,6500,500
01/16/25,Food,Snack,Almonds,1,8000,8000,0,7000,1000
01/16/25,Food,Beverages,Lemon Tea,5,4000,20000,0,15000,5000
01/16/25,Food,Beverages,Ocha,2,4000,8000,0,7000,1000
01/16/25,Food,Beverages,Lychee Tea,3,6000,18000,0,15000,3000
01/16/25,Food,Beverages,Oolong Tea,1,6000,6000,0,5000,1000
01/16/25,Food,Beverages,Soda,3,5000,15000,0,12000,3000
01/17/25,Food,Food,Takoyaki,3,10000,30000,0,24000,6000
01/17/25,Food,Food,Steak,4,60000,240000,0,220000,20000
01/17/25,Food,Food,Rendang,1,10000,10000,0,8000,2000
01/17/25,Food,Food,Fried Chicken,10,3000,30000,0,20000,10000
01/17/25,Food,Food,Noodles,8,6000,48000,0,40000,8000
01/17/25,Food,Food,Salmon,4,15000,60000,0,56000,4000
01/17/25,Food,Food,Macaroni,1,5000,5000,0,4000,1000
01/17/25,Food,Food,Fish & Chips,3,30000,90000,0,81000,9000
01/17/25,Food,Food,Burger,2,15000,30000,0,28000,2000
01/17/25,Food,Food,Hotdog,3,10000,30000,0,27000,3000
01/17/25,Food,Food,Pasta,1,18000,18000,0,16000,2000
01/17/25,Food,Snack,Chips,2,5000,10000,0,8000,2000
01/17/25,Food,Snack,Popcorn,1,7000,7000,0,6500,500
01/17/25,Food,Snack,Almonds,1,8000,8000,0,7000,1000
01/17/25,Food,Beverages,Lemon Tea,5,4000,20000,0,15000,5000
01/17/25,Food,Beverages,Ocha,2,4000,8000,0,7000,1000
01/17/25,Food,Beverages,Lychee Tea,3,6000,18000,0,15000,3000
01/17/25,Food,Beverages,Oolong Tea,1,6000,6000,0,5000,1000
01/17/25,Food,Beverages,Soda,3,5000,15000,0,12000,3000
01/18/25,Food,Food,Takoyaki,3,10000,30000,0,24000,6000
01/18/25,Food,Food,Steak,4,60000,240000,0,220000,20000
01/18/25,Food,Food,Rendang,1,10000,10000,0,8000,2000
01/18/25,Food,Food,Fried Chicken,10,3000,30000,0,20000,10000
01/18/25,Food,Food,Noodles,8,6000,48000,0,40000,8000
01/18/25,Food,Food,Salmon,4,15000,60000,0,56000,4000
01/18/25,Food,Food,Macaroni,1,5000,5000,0,4000,1000
01/18/25,Food,Food,Fish & Chips,3,30000,90000,0,81000,9000
01/18/25,Food,Food,Burger,2,15000,30000,0,28000,2000
01/18/25,Food,Food,Hotdog,3,10000,30000,0,27000,3000
01/18/25,Food,Food,Pasta,1,18000,18000,0,16000,2000
01/18/25,Food,Snack,Chips,2,5000,10000,0,8000,2000
01/18/25,Food,Snack,Popcorn,1,7000,7000,0,6500,500
01/18/25,Food,Snack,Almonds,1,8000,8000,0,7000,1000
01/18/25,Food,Beverages,Lemon Tea,5,4000,20000,0,15000,5000
01/18/25,Food,Beverages,Ocha,2,4000,8000,0,7000,1000
01/18/25,Food,Beverages,Lychee Tea,3,6000,18000,0,15000,3000
01/18/25,Food,Beverages,Oolong Tea,1,6000,6000,0,5000,1000
01/18/25,Food,Beverages,Soda,3,5000,15000,0,12000,3000
01/19/25,Food,Food,Takoyaki,3,10000,30000,0,24000,6000
01/19/25,Food,Food,Steak,4,60000,240000,0,220000,20000
01/19/25,Food,Food,Rendang,1,10000,10000,0,8000,2000
01/19/25,Food,Food,Fried Chicken,10,3000,30000,0,20000,10000
01/19/25,Food,Food,Noodles,8,6000,48000,0,40000,8000
01/19/25,Food,Food,Salmon,4,15000,60000,0,56000,4000
01/19/25,Food,Food,Macaroni,1,5000,5000,0,4000,1000
01/19/25,Food,Food,Fish & Chips,3,30000,90000,0,81000,9000
01/19/25,Food,Food,Burger,2,15000,30000,0,28000,2000
01/19/25,Food,Food,Hotdog,3,10000,30000,0,27000,3000
01/19/25,Food,Food,Pasta,1,18000,18000,0,16000,2000
01/19/25,Food,Snack,Chips,2,5000,10000,0,8000,2000
01/19/25,Food,Snack,Popcorn,1,7000,7000,0,6500,500
01/19/25,Food,Snack,Almonds,1,8000,8000,0,7000,1000
01/19/25,Food,Beverages,Lemon Tea,5,4000,20000,0,15000,5000
01/19/25,Food,Beverages,Ocha,2,4000,8000,0,7000,1000
01/19/25,Food,Beverages,Lychee Tea,3,6000,18000,0,15000,3000
01/19/25,Food,Beverages,Oolong Tea,1,6000,6000,0,5000,1000
01/19/25,Food,Beverages,Soda,3,5000,15000,0,12000,3000
01/20/25,Food,Food,Takoyaki,3,10000,30000,0,24000,6000
01/20/25,Food,Food,Steak,4,60000,240000,0,220000,20000
01/20/25,Food,Food,Rendang,1,10000,10000,0,8000,2000
01/20/25,Food,Food,Fried Chicken,10,3000,30000,0,20000,10000
01/20/25,Food,Food,Noodles,8,6000,48000,0,40000,8000
01/20/25,Food,Food,Salmon,4,15000,60000,0,56000,4000
01/20/25,Food,Food,Macaroni,1,5000,5000,0,4000,1000
01/20/25,Food,Food,Fish & Chips,3,30000,90000,0,81000,9000
01/20/25,Food,Food,Burger,2,15000,30000,0,28000,2000
01/20/25,Food,Food,Hotdog,3,10000,30000,0,27000,3000
01/20/25,Food,Food,Pasta,1,18000,18000,0,16000,2000
01/20/25,Food,Snack,Chips,2,5000,10000,0,8000,2000
01/20/25,Food,Snack,Popcorn,1,7000,7000,0,6500,500
01/20/25,Food,Snack,Almonds,1,8000,8000,0,7000,1000
01/20/25,Food,Beverages,Lemon Tea,5,4000,20000,0,15000,5000
01/20/25,Food,Beverages,Ocha,2,4000,8000,0,7000,1000
01/20/25,Food,Beverages,Lychee Tea,3,6000,18000,0,15000,3000
01/20/25,Food,Beverages,Oolong Tea,1,6000,6000,0,5000,1000
01/20/25,Food,Beverages,Soda,3,5000,15000,0,12000,3000
01/21/25,Food,Food,Takoyaki,3,10000,30000,0,24000,6000
01/21/25,Food,Food,Steak,4,60000,240000,0,220000,20000
01/21/25,Food,Food,Rendang,1,10000,10000,0,8000,2000
01/21/25,Food,Food,Fried Chicken,10,3000,30000,0,20000,10000
01/21/25,Food,Food,Noodles,8,6000,48000,0,40000,8000
01/21/25,Food,Food,Salmon,4,15000,60000,0,56000,4000
01/21/25,Food,Food,Macaroni,1,5000,5000,0,4000,1000
01/21/25,Food,Food,Fish & Chips,3,30000,90000,0,81000,9000
01/21/25,Food,Food,Burger,2,15000,30000,0,28000,2000
01/21/25,Food,Food,Hotdog,3,10000,30000,0,27000,3000
01/21/25,Food,Food,Pasta,1,18000,18000,0,16000,2000
01/21/25,Food,Snack,Chips,2,5000,10000,0,8000,2000
01/21/25,Food,Snack,Popcorn,1,7000,7000,0,6500,500
01/21/25,Food,Snack,Almonds,1,8000,8000,0,7000,1000
01/21/25,Food,Beverages,Lemon Tea,5,4000,20000,0,15000,5000
01/21/25,Food,Beverages,Ocha,2,4000,8000,0,7000,1000
01/21/25,Food,Beverages,Lychee Tea,3,6000,18000,0,15000,3000
01/21/25,Food,Beverages,Oolong Tea,1,6000,6000,0,5000,1000
01/21/25,Food,Beverages,Soda,3,5000,15000,0,12000,3000
01/22/25,Food,Food,Takoyaki,3,10000,30000,0,24000,6000
01/22/25,Food,Food,Steak,4,60000,240000,0,220000,20000
01/22/25,Food,Food,Rendang,1,10000,10000,0,8000,2000
01/22/25,Food,Food,Fried Chicken,10,3000,30000,0,20000,10000
01/22/25,Food,Food,Noodles,8,6000,48000,0,40000,8000
01/22/25,Food,Food,Salmon,4,15000,60000,0,56000,4000
01/22/25,Food,Food,Macaroni,1,5000,5000,0,4000,1000
01/22/25,Food,Food,Fish & Chips,3,30000,90000,0,81000,9000
01/22/25,Food,Food,Burger,2,15000,30000,0,28000,2000
01/22/25,Food,Food,Hotdog,3,10000,30000,0,27000,3000
01/22/25,Food,Food,Pasta,1,18000,18000,0,16000,2000
01/22/25,Food,Snack,Chips,2,5000,10000,0,8000,2000
01/22/25,Food,Snack,Popcorn,1,7000,7000,0,6500,500
01/22/25,Food,Snack,Almonds,1,8000,8000,0,7000,1000
01/22/25,Food,Beverages,Lemon Tea,5,4000,20000,0,15000,5000
01/22/25,Food,Beverages,Ocha,2,4000,8000,0,7000,1000
01/22/25,Food,Beverages,Lychee Tea,3,6000,18000,0,15000,3000
01/22/25,Food,Beverages,Oolong Tea,1,6000,6000,0,5000,1000
01/22/25,Food,Beverages,Soda,3,5000,15000,0,12000,3000
01/23/25,Food,Food,Takoyaki,3,10000,30000,0,24000,6000
01/23/25,Food,Food,Steak,4,60000,240000,0,220000,20000
01/23/25,Food,Food,Rendang,1,10000,10000,0,8000,2000
01/23/25,Food,Food,Fried Chicken,10,3000,30000,0,20000,10000
01/23/25,Food,Food,Noodles,8,6000,48000,0,40000,8000
01/23/25,Food,Food,Salmon,4,15000,60000,0,56000,4000
01/23/25,Food,Food,Macaroni,1,5000,5000,0,4000,1000
01/23/25,Food,Food,Fish & Chips,3,30000,90000,0,81000,9000
01/23/25,Food,Food,Burger,2,15000,30000,0,28000,2000
01/23/25,Food,Food,Hotdog,3,10000,30000,0,27000,3000
01/23/25,Food,Food,Pasta,1,18000,18000,0,16000,2000
01/23/25,Food,Snack,Chips,2,5000,10000,0,8000,2000
01/23/25,Food,Snack,Popcorn,1,7000,7000,0,6500,500
01/23/25,Food,Snack,Almonds,1,8000,8000,0,7000,1000
01/23/25,Food,Beverages,Lemon Tea,5,4000,20000,0,15000,5000
01/23/25,Food,Beverages,Ocha,2,4000,8000,0,7000,1000
01/23/25,Food,Beverages,Lychee Tea,3,6000,18000,0,15000,3000
01/23/25,Food,Beverages,Oolong Tea,1,6000,6000,0,5000,1000
01/23/25,Food,Beverages,Soda,3,5000,15000,0,12000,3000
01/24/25,Food,Food,Takoyaki,3,10000,30000,0,24000,6000
01/24/25,Food,Food,Steak,4,60000,240000,0,220000,20000
01/24/25,Food,Food,Rendang,1,10000,10000,0,8000,2000
01/24/25,Food,Food,Fried Chicken,10,3000,30000,0,20000,10000
01/24/25,Food,Food,Noodles,8,6000,48000,0,40000,8000
01/24/25,Food,Food,Salmon,4,15000,60000,0,56000,4000
01/24/25,Food,Food,Macaroni,1,5000,5000,0,4000,1000
01/24/25,Food,Food,Fish & Chips,3,30000,90000,0,81000,9000
01/24/25,Food,Food,Burger,2,15000,30000,0,28000,2000
01/24/25,Food,Food,Hotdog,3,10000,30000,0,27000,3000
01/24/25,Food,Food,Pasta,1,18000,18000,0,16000,2000
01/24/25,Food,Snack,Chips,2,5000,10000,0,8000,2000
01/24/25,Food,Snack,Popcorn,1,7000,7000,0,6500,500
01/24/25,Food,Snack,Almonds,1,8000,8000,0,7000,1000
01/24/25,Food,Beverages,Lemon Tea,5,4000,20000,0,15000,5000
01/24/25,Food,Beverages,Ocha,2,4000,8000,0,7000,1000
01/24/25,Food,Beverages,Lychee Tea,3,6000,18000,0,15000,3000
01/24/25,Food,Beverages,Oolong Tea,1,6000,6000,0,5000,1000
01/24/25,Food,Beverages,Soda,3,5000,15000,0,12000,3000
01/25/25,Food,Food,Takoyaki,3,10000,30000,0,24000,6000
01/25/25,Food,Food,Steak,4,60000,240000,0,220000,20000
01/25/25,Food,Food,Rendang,1,10000,10000,0,8000,2000
01/25/25,Food,Food,Fried Chicken,10,3000,30000,0,20000,10000
01/25/25,Food,Food,Noodles,8,6000,48000,0,40000,8000
01/25/25,Food,Food,Salmon,4,15000,60000,0,56000,4000
01/25/25,Food,Food,Macaroni,1,5000,5000,0,4000,1000
01/25/25,Food,Food,Fish & Chips,3,30000,90000,0,81000,9000
01/25/25,Food,Food,Burger,2,15000,30000,0,28000,2000
01/25/25,Food,Food,Hotdog,3,10000,30000,0,27000,3000
01/25/25,Food,Food,Pasta,1,18000,18000,0,16000,2000
01/25/25,Food,Snack,Chips,2,5000,10000,0,8000,2000
01/25/25,Food,Snack,Popcorn,1,7000,7000,0,6500,500
01/25/25,Food,Snack,Almonds,1,8000,8000,0,7000,1000
01/25/25,Food,Beverages,Lemon Tea,5,4000,20000,0,15000,5000
01/25/25,Food,Beverages,Ocha,2,4000,8000,0,7000,1000
01/25/25,Food,Beverages,Lychee Tea,3,6000,18000,0,15000,3000
01/25/25,Food,Beverages,Oolong Tea,1,6000,6000,0,5000,1000
01/25/25,Food,Beverages,Soda,3,5000,15000,0,12000,3000
01/26/25,Food,Food,Takoyaki,3,10000,30000,0,24000,6000
01/26/25,Food,Food,Steak,4,60000,240000,0,220000,20000
01/26/25,Food,Food,Rendang,1,10000,10000,0,8000,2000
01/26/25,Food,Food,Fried Chicken,10,3000,30000,0,20000,10000
01/26/25,Food,Food,Noodles,8,6000,48000,0,40000,8000
01/26/25,Food,Food,Salmon,4,15000,60000,0,56000,4000
01/26/25,Food,Food,Macaroni,1,5000,5000,0,4000,1000
01/26/25,Food,Food,Fish & Chips,3,30000,90000,0,81000,9000
01/26/25,Food,Food,Burger,2,15000,30000,0,28000,2000
01/26/25,Food,Food,Hotdog,3,10000,30000,0,27000,3000
01/26/25,Food,Food,Pasta,1,18000,18000,0,16000,2000
01/26/25,Food,Snack,Chips,2,5000,10000,0,8000,2000
01/26/25,Food,Snack,Popcorn,1,7000,7000,0,6500,500
01/26/25,Food,Snack,Almonds,1,8000,8000,0,7000,1000
01/26/25,Food,Beverages,Lemon Tea,5,4000,20000,0,15000,5000
01/26/25,Food,Beverages,Ocha,2,4000,8000,0,7000,1000
01/26/25,Food,Beverages,Lychee Tea,3,6000,18000,0,15000,3000
01/26/25,Food,Beverages,Oolong Tea,1,6000,6000,0,5000,1000
01/26/25,Food,Beverages,Soda,3,5000,15000,0,12000,3000
01/27/25,Food,Food,Takoyaki,3,10000,30000,0,24000,6000
01/27/25,Food,Food,Steak,4,60000,240000,0,220000,20000
01/27/25,Food,Food,Rendang,1,10000,10000,0,8000,2000
01/27/25,Food,Food,Fried Chicken,10,3000,30000,0,20000,10000
01/27/25,Food,Food,Noodles,8,6000,48000,0,40000,8000
01/27/25,Food,Food,Salmon,4,15000,60000,0,56000,4000
01/27/25,Food,Food,Macaroni,1,5000,5000,0,4000,1000
01/27/25,Food,Food,Fish & Chips,3,30000,90000,0,81000,9000
01/27/25,Food,Food,Burger,2,15000,30000,0,28000,2000
01/27/25,Food,Food,Hotdog,3,10000,30000,0,27000,3000
01/27/25,Food,Food,Pasta,1,18000,18000,0,16000,2000
01/27/25,Food,Snack,Chips,2,5000,10000,0,8000,2000
01/27/25,Food,Snack,Popcorn,1,7000,7000,0,6500,500
01/27/25,Food,Snack,Almonds,1,8000,8000,0,7000,1000
01/27/25,Food,Beverages,Lemon Tea,5,4000,20000,0,15000,5000
01/27/25,Food,Beverages,Ocha,2,4000,8000,0,7000,1000
01/27/25,Food,Beverages,Lychee Tea,3,6000,18000,0,15000,3000
01/27/25,Food,Beverages,Oolong Tea,1,6000,6000,0,5000,1000
01/27/25,Food,Beverages,Soda,3,5000,15000,0,12000,3000
01/28/25,Food,Food,Takoyaki,3,10000,30000,0,24000,6000
01/28/25,Food,Food,Steak,4,60000,240000,0,220000,20000
01/28/25,Food,Food,Rendang,1,10000,10000,0,8000,2000
01/28/25,Food,Food,Fried Chicken,10,3000,30000,0,20000,10000
01/28/25,Food,Food,Noodles,8,6000,48000,0,40000,8000
01/28/25,Food,Food,Salmon,4,15000,60000,0,56000,4000
01/28/25,Food,Food,Macaroni,1,5000,5000,0,4000,1000
01/28/25,Food,Food,Fish & Chips,3,30000,90000,0,81000,9000
01/28/25,Food,Food,Burger,2,15000,30000,0,28000,2000
01/28/25,Food,Food,Hotdog,3,10000,30000,0,27000,3000
01/28/25,Food,Food,Pasta,1,18000,18000,0,16000,2000
01/28/25,Food,Snack,Chips,2,5000,10000,0,8000,2000
01/28/25,Food,Snack,Popcorn,1,7000,7000,0,6500,500
01/28/25,Food,Snack,Almonds,1,8000,8000,0,7000,1000
01/28/25,Food,Beverages,Lemon Tea,5,4000,20000,0,15000,5000
01/28/25,Food,Beverages,Ocha,2,4000,8000,0,7000,1000
01/28/25,Food,Beverages,Lychee Tea,3,6000,18000,0,15000,3000
01/28/25,Food,Beverages,Oolong Tea,1,6000,6000,0,5000,1000
01/28/25,Food,Beverages,Soda,3,5000,15000,0,12000,3000
01/29/25,Food,Food,Takoyaki,3,10000,30000,0,24000,6000
01/29/25,Food,Food,Steak,4,60000,240000,0,220000,20000
01/29/25,Food,Food,Rendang,1,10000,10000,0,8000,2000
01/29/25,Food,Food,Fried Chicken,10,3000,30000,0,20000,10000
01/29/25,Food,Food,Noodles,8,6000,48000,0,40000,8000
01/29/25,Food,Food,Salmon,4,15000,60000,0,56000,4000
01/29/25,Food,Food,Macaroni,1,5000,5000,0,4000,1000
01/29/25,Food,Food,Fish & Chips,3,30000,90000,0,81000,9000
01/29/25,Food,Food,Burger,2,15000,30000,0,28000,2000
01/29/25,Food,Food,Hotdog,3,10000,30000,0,27000,3000
01/29/25,Food,Food,Pasta,1,18000,18000,0,16000,2000
01/29/25,Food,Snack,Chips,2,5000,10000,0,8000,2000
01/29/25,Food,Snack,Popcorn,1,7000,7000,0,6500,500
01/29/25,Food,Snack,Almonds,1,8000,8000,0,7000,1000
01/29/25,Food,Beverages,Lemon Tea,5,4000,20000,0,15000,5000
01/29/25,Food,Beverages,Ocha,2,4000,8000,0,7000,1000
01/29/25,Food,Beverages,Lychee Tea,3,6000,18000,0,15000,3000
01/29/25,Food,Beverages,Oolong Tea,1,6000,6000,0,5000,1000
01/29/25,Food,Beverages,Soda,3,5000,15000,0,12000,3000
01/30/25,Food,Food,Takoyaki,3,10000,30000,0,24000,6000
01/30/25,Food,Food,Steak,4,60000,240000,0,220000,20000
01/30/25,Food,Food,Rendang,1,10000,10000,0,8000,2000
01/30/25,Food,Food,Fried Chicken,10,3000,30000,0,20000,10000
01/30/25,Food,Food,Noodles,8,6000,48000,0,40000,8000
01/30/25,Food,Food,Salmon,4,15000,60000,0,56000,4000
01/30/25,Food,Food,Macaroni,1,5000,5000,0,4000,1000
01/30/25,Food,Food,Fish & Chips,3,30000,90000,0,81000,9000
01/30/25,Food,Food,Burger,2,15000,30000,0,28000,2000
01/30/25,Food,Food,Hotdog,3,10000,30000,0,27000,3000
01/30/25,Food,Food,Pasta,1,18000,18000,0,16000,2000
01/30/25,Food,Snack,Chips,2,5000,10000,0,8000,2000
01/30/25,Food,Snack,Popcorn,1,7000,7000,0,6500,500
01/30/25,Food,Snack,Almonds,1,8000,8000,0,7000,1000
01/30/25,Food,Beverages,Lemon Tea,5,4000,20000,0,15000,5000
01/30/25,Food,Beverages,Ocha,2,4000,8000,0,7000,1000
01/30/25,Food,Beverages,Lychee Tea,3,6000,18000,0,15000,3000
01/30/25,Food,Beverages,Oolong Tea,1,6000,6000,0,5000,1000
01/30/25,Food,Beverages,Soda,3,5000,15000,0,12000,3000
01/31/25,Food,Food,Takoyaki,3,10000,30000,0,24000,6000
01/31/25,Food,Food,Steak,4,60000,240000,0,220000,20000
01/31/25,Food,Food,Rendang,1,10000,10000,0,8000,2000
01/31/25,Food,Food,Fried Chicken,10,3000,30000,0,20000,10000
01/31/25,Food,Food,Noodles,8,6000,48000,0,40000,8000
01/31/25,Food,Food,Salmon,4,15000,60000,0,56000,4000
01/31/25,Food,Food,Macaroni,1,5000,5000,0,4000,1000
01/31/25,Food,Food,Fish & Chips,3,30000,90000,0,81000,9000
01/31/25,Food,Food,Burger,2,15000,30000,0,28000,2000
01/31/25,Food,Food,Hotdog,3,10000,30000,0,27000,3000
01/31/25,Food,Food,Pasta,1,18000,18000,0,16000,2000
01/31/25,Food,Snack,Chips,2,5000,10000,0,8000,2000
01/31/25,Food,Snack,Popcorn,1,7000,7000,0,6500,500
01/31/25,Food,Snack,Almonds,1,8000,8000,0,7000,1000
01/31/25,Food,Beverages,Lemon Tea,5,4000,20000,0,15000,5000
01/31/25,Food,Beverages,Ocha,2,4000,8000,0,7000,1000
01/31/25,Food,Beverages,Lychee Tea,3,6000,18000,0,15000,3000
01/31/25,Food,Beverages,Oolong Tea,1,6000,6000,0,5000,1000
01/31/25,Food,Beverages,Soda,3,5000,15000,0,12000,3000
02/01/25,Food,Food,Takoyaki,3,10000,30000,0,24000,6000
02/01/25,Food,Food,Steak,4,60000,240000,0,220000,20000
02/01/25,Food,Food,Rendang,1,10000,10000,0,8000,2000
02/01/25,Food,Food,Fried Chicken,10,3000,30000,0,20000,10000
02/01/25,Food,Food,Noodles,8,6000,48000,0,40000,8000
02/01/25,Food,Food,Salmon,4,15000,60000,0,56000,4000
02/01/25,Food,Food,Macaroni,1,5000,5000,0,4000,1000
02/01/25,Food,Food,Fish & Chips,3,30000,90000,0,81000,9000
02/01/25,Food,Food,Burger,2,15000,30000,0,28000,2000
02/01/25,Food,Food,Hotdog,3,10000,30000,0,27000,3000
02/01/25,Food,Food,Pasta,1,18000,18000,0,16000,2000
02/01/25,Food,Snack,Chips,2,5000,10000,0,8000,2000
02/01/25,Food,Snack,Popcorn,1,7000,7000,0,6500,500
02/01/25,Food,Snack,Almonds,1,8000,8000,0,7000,1000
02/01/25,Food,Beverages,Lemon Tea,5,4000,20000,0,15000,5000
02/01/25,Food,Beverages,Ocha,2,4000,8000,0,7000,1000
02/01/25,Food,Beverages,Lychee Tea,3,6000,18000,0,15000,3000
02/01/25,Food,Beverages,Oolong Tea,1,6000,6000,0,5000,1000
02/01/25,Food,Beverages,Soda,3,5000,15000,0,12000,3000
02/02/25,Food,Food,Takoyaki,3,10000,30000,0,24000,6000
02/02/25,Food,Food,Steak,4,60000,240000,0,220000,20000
02/02/25,Food,Food,Rendang,1,10000,10000,0,8000,2000
02/02/25,Food,Food,Fried Chicken,10,3000,30000,0,20000,10000
02/02/25,Food,Food,Noodles,8,6000,48000,0,40000,8000
02/02/25,Food,Food,Salmon,4,15000,60000,0,56000,4000
02/02/25,Food,Food,Macaroni,1,5000,5000,0,4000,1000
02/02/25,Food,Food,Fish & Chips,3,30000,90000,0,81000,9000
02/02/25,Food,Food,Burger,2,15000,30000,0,28000,2000
02/02/25,Food,Food,Hotdog,3,10000,30000,0,27000,3000
02/02/25,Food,Food,Pasta,1,18000,18000,0,16000,2000
02/02/25,Food,Snack,Chips,2,5000,10000,0,8000,2000
02/02/25,Food,Snack,Popcorn,1,7000,7000,0,6500,500
02/02/25,Food,Snack,Almonds,1,8000,8000,0,7000,1000
02/02/25,Food,Beverages,Lemon Tea,5,4000,20000,0,15000,5000
02/02/25,Food,Beverages,Ocha,2,4000,8000,0,7000,1000
02/02/25,Food,Beverages,Lychee Tea,3,6000,18000,0,15000,3000
02/02/25,Food,Beverages,Oolong Tea,1,6000,6000,0,5000,1000
02/02/25,Food,Beverages,Soda,3,5000,15000,0,12000,3000
02/03/25,Food,Food,Takoyaki,3,10000,30000,0,24000,6000
02/03/25,Food,Food,Steak,4,60000,240000,0,220000,20000
02/03/25,Food,Food,Rendang,1,10000,10000,0,8000,2000
02/03/25,Food,Food,Fried Chicken,10,3000,30000,0,20000,10000
02/03/25,Food,Food,Noodles,8,6000,48000,0,40000,8000
02/03/25,Food,Food,Salmon,4,15000,60000,0,56000,4000
02/03/25,Food,Food,Macaroni,1,5000,5000,0,4000,1000
02/03/25,Food,Food,Fish & Chips,3,30000,90000,0,81000,9000
02/03/25,Food,Food,Burger,2,15000,30000,0,28000,2000
02/03/25,Food,Food,Hotdog,3,10000,30000,0,27000,3000
02/03/25,Food,Food,Pasta,1,18000,18000,0,16000,2000
02/03/25,Food,Snack,Chips,2,5000,10000,0,8000,2000
02/03/25,Food,Snack,Popcorn,1,7000,7000,0,6500,500
02/03/25,Food,Snack,Almonds,1,8000,8000,0,7000,1000
02/03/25,Food,Beverages,Lemon Tea,5,4000,20000,0,15000,5000
02/03/25,Food,Beverages,Ocha,2,4000,8000,0,7000,1000
02/03/25,Food,Beverages,Lychee Tea,3,6000,18000,0,15000,3000
02/03/25,Food,Beverages,Oolong Tea,1,6000,6000,0,5000,1000
02/03/25,Food,Beverages,Soda,3,5000,15000,0,12000,3000
02/04/25,Food,Food,Takoyaki,3,10000,30000,0,24000,6000
02/04/25,Food,Food,Steak,4,60000,240000,0,220000,20000
02/04/25,Food,Food,Rendang,1,10000,10000,0,8000,2000
02/04/25,Food,Food,Fried Chicken,10,3000,30000,0,20000,10000
02/04/25,Food,Food,Noodles,8,6000,48000,0,40000,8000
02/04/25,Food,Food,Salmon,4,15000,60000,0,56000,4000
02/04/25,Food,Food,Macaroni,1,5000,5000,0,4000,1000
02/04/25,Food,Food,Fish & Chips,3,30000,90000,0,81000,9000
02/04/25,Food,Food,Burger,2,15000,30000,0,28000,2000
02/04/25,Food,Food,Hotdog,3,10000,30000,0,27000,3000
02/04/25,Food,Food,Pasta,1,18000,18000,0,16000,2000
02/04/25,Food,Snack,Chips,2,5000,10000,0,8000,2000
02/04/25,Food,Snack,Popcorn,1,7000,7000,0,6500,500
02/04/25,Food,Snack,Almonds,1,8000,8000,0,7000,1000
02/04/25,Food,Beverages,Lemon Tea,5,4000,20000,0,15000,5000
02/04/25,Food,Beverages,Ocha,2,4000,8000,0,7000,1000
02/04/25,Food,Beverages,Lychee Tea,3,6000,18000,0,15000,3000
02/04/25,Food,Beverages,Oolong Tea,1,6000,6000,0,5000,1000
02/04/25,Food,Beverages,Soda,3,5000,15000,0,12000,3000
02/05/25,Food,Food,Takoyaki,3,10000,30000,0,24000,6000
02/05/25,Food,Food,Steak,4,60000,240000,0,220000,20000
02/05/25,Food,Food,Rendang,1,10000,10000,0,8000,2000
02/05/25,Food,Food,Fried Chicken,10,3000,30000,0,20000,10000
02/05/25,Food,Food,Noodles,8,6000,48000,0,40000,8000
02/05/25,Food,Food,Salmon,4,15000,60000,0,56000,4000
02/05/25,Food,Food,Macaroni,1,5000,5000,0,4000,1000
02/05/25,Food,Food,Fish & Chips,3,30000,90000,0,81000,9000
02/05/25,Food,Food,Burger,2,15000,30000,0,28000,2000
02/05/25,Food,Food,Hotdog,3,10000,30000,0,27000,3000
02/05/25,Food,Food,Pasta,1,18000,18000,0,16000,2000
02/05/25,Food,Snack,Chips,2,5000,10000,0,8000,2000
02/05/25,Food,Snack,Popcorn,1,7000,7000,0,6500,500
02/05/25,Food,Snack,Almonds,1,8000,8000,0,7000,1000
02/05/25,Food,Beverages,Lemon Tea,5,4000,20000,0,15000,5000
02/05/25,Food,Beverages,Ocha,2,4000,8000,0,7000,1000
02/05/25,Food,Beverages,Lychee Tea,3,6000,18000,0,15000,3000
02/05/25,Food,Beverages,Oolong Tea,1,6000,6000,0,5000,1000
02/05/25,Food,Beverages,Soda,3,5000,15000,0,12000,3000
02/06/25,Food,Food,Takoyaki,3,10000,30000,0,24000,6000
02/06/25,Food,Food,Steak,4,60000,240000,0,220000,20000
02/06/25,Food,Food,Rendang,1,10000,10000,0,8000,2000
02/06/25,Food,Food,Fried Chicken,10,3000,30000,0,20000,10000
02/06/25,Food,Food,Noodles,8,6000,48000,0,40000,8000
02/06/25,Food,Food,Salmon,4,15000,60000,0,56000,4000
02/06/25,Food,Food,Macaroni,1,5000,5000,0,4000,1000
02/06/25,Food,Food,Fish & Chips,3,30000,90000,0,81000,9000
02/06/25,Food,Food,Burger,2,15000,30000,0,28000,2000
02/06/25,Food,Food,Hotdog,3,10000,30000,0,27000,3000
02/06/25,Food,Food,Pasta,1,18000,18000,0,16000,2000
02/06/25,Food,Snack,Chips,2,5000,10000,0,8000,2000
02/06/25,Food,Snack,Popcorn,1,7000,7000,0,6500,500
02/06/25,Food,Snack,Almonds,1,8000,8000,0,7000,1000
02/06/25,Food,Beverages,Lemon Tea,5,4000,20000,0,15000,5000
02/06/25,Food,Beverages,Ocha,2,4000,8000,0,7000,1000
02/06/25,Food,Beverages,Lychee Tea,3,6000,18000,0,15000,3000
02/06/25,Food,Beverages,Oolong Tea,1,6000,6000,0,5000,1000
02/06/25,Food,Beverages,Soda,3,5000,15000,0,12000,3000
02/07/25,Food,Food,Takoyaki,3,10000,30000,0,24000,6000
02/07/25,Food,Food,Steak,4,60000,240000,0,220000,20000
02/07/25,Food,Food,Rendang,1,10000,10000,0,8000,2000
02/07/25,Food,Food,Fried Chicken,10,3000,30000,0,20000,10000
02/07/25,Food,Food,Noodles,8,6000,48000,0,40000,8000
02/07/25,Food,Food,Salmon,4,15000,60000,0,56000,4000
02/07/25,Food,Food,Macaroni,1,5000,5000,0,4000,1000
02/07/25,Food,Food,Fish & Chips,3,30000,90000,0,81000,9000
02/07/25,Food,Food,Burger,2,15000,30000,0,28000,2000
02/07/25,Food,Food,Hotdog,3,10000,30000,0,27000,3000
02/07/25,Food,Food,Pasta,1,18000,18000,0,16000,2000
02/07/25,Food,Snack,Chips,2,5000,10000,0,8000,2000
02/07/25,Food,Snack,Popcorn,1,7000,7000,0,6500,500
02/07/25,Food,Snack,Almonds,1,8000,8000,0,7000,1000
02/07/25,Food,Beverages,Lemon Tea,5,4000,20000,0,15000,5000
02/07/25,Food,Beverages,Ocha,2,4000,8000,0,7000,1000
02/07/25,Food,Beverages,Lychee Tea,3,6000,18000,0,15000,3000
02/07/25,Food,Beverages,Oolong Tea,1,6000,6000,0,5000,1000
02/07/25,Food,Beverages,Soda,3,5000,15000,0,12000,3000
02/08/25,Food,Food,Takoyaki,3,10000,30000,0,24000,6000
02/08/25,Food,Food,Steak,4,60000,240000,0,220000,20000
02/08/25,Food,Food,Rendang,1,10000,10000,0,8000,2000
02/08/25,Food,Food,Fried Chicken,10,3000,30000,0,20000,10000
02/08/25,Food,Food,Noodles,8,6000,48000,0,40000,8000
02/08/25,Food,Food,Salmon,4,15000,60000,0,56000,4000
02/08/25,Food,Food,Macaroni,1,5000,5000,0,4000,1000
02/08/25,Food,Food,Fish & Chips,3,30000,90000,0,81000,9000
02/08/25,Food,Food,Burger,2,15000,30000,0,28000,2000
02/08/25,Food,Food,Hotdog,3,10000,30000,0,27000,3000
02/08/25,Food,Food,Pasta,1,18000,18000,0,16000,2000
02/08/25,Food,Snack,Chips,2,5000,10000,0,8000,2000
02/08/25,Food,Snack,Popcorn,1,7000,7000,0,6500,500
02/08/25,Food,Snack,Almonds,1,8000,8000,0,7000,1000
02/08/25,Food,Beverages,Lemon Tea,5,4000,20000,0,15000,5000
02/08/25,Food,Beverages,Ocha,2,4000,8000,0,7000,1000
02/08/25,Food,Beverages,Lychee Tea,3,6000,18000,0,15000,3000
02/08/25,Food,Beverages,Oolong Tea,1,6000,6000,0,5000,1000
02/08/25,Food,Beverages,Soda,3,5000,15000,0,12000,3000
02/09/25,Food,Food,Takoyaki,3,10000,30000,0,24000,6000
02/09/25,Food,Food,Steak,4,60000,240000,0,220000,20000
02/09/25,Food,Food,Rendang,1,10000,10000,0,8000,2000
02/09/25,Food,Food,Fried Chicken,10,3000,30000,0,20000,10000
02/09/25,Food,Food,Noodles,8,6000,48000,0,40000,8000
02/09/25,Food,Food,Salmon,4,15000,60000,0,56000,4000
02/09/25,Food,Food,Macaroni,1,5000,5000,0,4000,1000
02/09/25,Food,Food,Fish & Chips,3,30000,90000,0,81000,9000
02/09/25,Food,Food,Burger,2,15000,30000,0,28000,2000
02/09/25,Food,Food,Hotdog,3,10000,30000,0,27000,3000
02/09/25,Food,Food,Pasta,1,18000,18000,0,16000,2000
02/09/25,Food,Snack,Chips,2,5000,10000,0,8000,2000
02/09/25,Food,Snack,Popcorn,1,7000,7000,0,6500,500
02/09/25,Food,Snack,Almonds,1,8000,8000,0,7000,1000
02/09/25,Food,Beverages,Lemon Tea,5,4000,20000,0,15000,5000
02/09/25,Food,Beverages,Ocha,2,4000,8000,0,7000,1000
02/09/25,Food,Beverages,Lychee Tea,3,6000,18000,0,15000,3000
02/09/25,Food,Beverages,Oolong Tea,1,6000,6000,0,5000,1000
02/09/25,Food,Beverages,Soda,3,5000,15000,0,12000,3000
02/10/25,Food,Food,Takoyaki,3,10000,30000,0,24000,6000
02/10/25,Food,Food,Steak,4,60000,240000,0,220000,20000
02/10/25,Food,Food,Rendang,1,10000,10000,0,8000,2000
02/10/25,Food,Food,Fried Chicken,10,3000,30000,0,20000,10000
02/10/25,Food,Food,Noodles,8,6000,48000,0,40000,8000
02/10/25,Food,Food,Salmon,4,15000,60000,0,56000,4000
02/10/25,Food,Food,Macaroni,1,5000,5000,0,4000,1000
02/10/25,Food,Food,Fish & Chips,3,30000,90000,0,81000,9000
02/10/25,Food,Food,Burger,2,15000,30000,0,28000,2000
02/10/25,Food,Food,Hotdog,3,10000,30000,0,27000,3000
02/10/25,Food,Food,Pasta,1,18000,18000,0,16000,2000
02/10/25,Food,Snack,Chips,2,5000,10000,0,8000,2000
02/10/25,Food,Snack,Popcorn,1,7000,7000,0,6500,500
02/10/25,Food,Snack,Almonds,1,8000,8000,0,7000,1000
02/10/25,Food,Beverages,Lemon Tea,5,4000,20000,0,15000,5000
02/10/25,Food,Beverages,Ocha,2,4000,8000,0,7000,1000
02/10/25,Food,Beverages,Lychee Tea,3,6000,18000,0,15000,3000
02/10/25,Food,Beverages,Oolong Tea,1,6000,6000,0,5000,1000
02/10/25,Food,Beverages,Soda,3,5000,15000,0,12000,3000
02/11/25,Food,Food,Takoyaki,3,10000,30000,0,24000,6000
02/11/25,Food,Food,Steak,4,60000,240000,0,220000,20000
02/11/25,Food,Food,Rendang,1,10000,10000,0,8000,2000
02/11/25,Food,Food,Fried Chicken,10,3000,30000,0,20000,10000
02/11/25,Food,Food,Noodles,8,6000,48000,0,40000,8000
02/11/25,Food,Food,Salmon,4,15000,60000,0,56000,4000
02/11/25,Food,Food,Macaroni,1,5000,5000,0,4000,1000
02/11/25,Food,Food,Fish & Chips,3,30000,90000,0,81000,9000
02/11/25,Food,Food,Burger,2,15000,30000,0,28000,2000
02/11/25,Food,Food,Hotdog,3,10000,30000,0,27000,3000
02/11/25,Food,Food,Pasta,1,18000,18000,0,16000,2000
02/11/25,Food,Snack,Chips,2,5000,10000,0,8000,2000
02/11/25,Food,Snack,Popcorn,1,7000,7000,0,6500,500
02/11/25,Food,Snack,Almonds,1,8000,8000,0,7000,1000
02/11/25,Food,Beverages,Lemon Tea,5,4000,20000,0,15000,5000
02/11/25,Food,Beverages,Ocha,2,4000,8000,0,7000,1000
02/11/25,Food,Beverages,Lychee Tea,3,6000,18000,0,15000,3000
02/11/25,Food,Beverages,Oolong Tea,1,6000,6000,0,5000,1000
02/11/25,Food,Beverages,Soda,3,5000,15000,0,12000,3000
02/12/25,Food,Food,Takoyaki,3,10000,30000,0,24000,6000
02/12/25,Food,Food,Steak,4,60000,240000,0,220000,20000
02/12/25,Food,Food,Rendang,1,10000,10000,0,8000,2000
02/12/25,Food,Food,Fried Chicken,10,3000,30000,0,20000,10000
02/12/25,Food,Food,Noodles,8,6000,48000,0,40000,8000
02/12/25,Food,Food,Salmon,4,15000,60000,0,56000,4000
02/12/25,Food,Food,Macaroni,1,5000,5000,0,4000,1000
02/12/25,Food,Food,Fish & Chips,3,30000,90000,0,81000,9000
02/12/25,Food,Food,Burger,2,15000,30000,0,28000,2000
02/12/25,Food,Food,Hotdog,3,10000,30000,0,27000,3000
02/12/25,Food,Food,Pasta,1,18000,18000,0,16000,2000
02/12/25,Food,Snack,Chips,2,5000,10000,0,8000,2000
02/12/25,Food,Snack,Popcorn,1,7000,7000,0,6500,500
02/12/25,Food,Snack,Almonds,1,8000,8000,0,7000,1000
02/12/25,Food,Beverages,Lemon Tea,5,4000,20000,0,15000,5000
02/12/25,Food,Beverages,Ocha,2,4000,8000,0,7000,1000
02/12/25,Food,Beverages,Lychee Tea,3,6000,18000,0,15000,3000
02/12/25,Food,Beverages,Oolong Tea,1,6000,6000,0,5000,1000
02/12/25,Food,Beverages,Soda,3,5000,15000,0,12000,3000
02/13/25,Food,Food,Takoyaki,3,10000,30000,0,24000,6000
02/13/25,Food,Food,Steak,4,60000,240000,0,220000,20000
02/13/25,Food,Food,Rendang,1,10000,10000,0,8000,2000
02/13/25,Food,Food,Fried Chicken,10,3000,30000,0,20000,10000
02/13/25,Food,Food,Noodles,8,6000,48000,0,40000,8000
02/13/25,Food,Food,Salmon,4,15000,60000,0,56000,4000
02/13/25,Food,Food,Macaroni,1,5000,5000,0,4000,1000
02/13/25,Food,Food,Fish & Chips,3,30000,90000,0,81000,9000
02/13/25,Food,Food,Burger,2,15000,30000,0,28000,2000
02/13/25,Food,Food,Hotdog,3,10000,30000,0,27000,3000
02/13/25,Food,Food,Pasta,1,18000,18000,0,16000,2000
02/13/25,Food,Snack,Chips,2,5000,10000,0,8000,2000
02/13/25,Food,Snack,Popcorn,1,7000,7000,0,6500,500
02/13/25,Food,Snack,Almonds,1,8000,8000,0,7000,1000
02/13/25,Food,Beverages,Lemon Tea,5,4000,20000,0,15000,5000
02/13/25,Food,Beverages,Ocha,2,4000,8000,0,7000,1000
02/13/25,Food,Beverages,Lychee Tea,3,6000,18000,0,15000,3000
02/13/25,Food,Beverages,Oolong Tea,1,6000,6000,0,5000,1000
02/13/25,Food,Beverages,Soda,3,5000,15000,0,12000,3000
02/14/25,Food,Food,Takoyaki,3,10000,30000,0,24000,6000
02/14/25,Food,Food,Steak,4,60000,240000,0,220000,20000
02/14/25,Food,Food,Rendang,1,10000,10000,0,8000,2000
02/14/25,Food,Food,Fried Chicken,10,3000,30000,0,20000,10000
02/14/25,Food,Food,Noodles,8,6000,48000,0,40000,8000
02/14/25,Food,Food,Salmon,4,15000,60000,0,56000,4000
02/14/25,Food,Food,Macaroni,1,5000,5000,0,4000,1000
02/14/25,Food,Food,Fish & Chips,3,30000,90000,0,81000,9000
02/14/25,Food,Food,Burger,2,15000,30000,0,28000,2000
02/14/25,Food,Food,Hotdog,3,10000,30000,0,27000,3000
02/14/25,Food,Food,Pasta,1,18000,18000,0,16000,2000
02/14/25,Food,Snack,Chips,2,5000,10000,0,8000,2000
02/14/25,Food,Snack,Popcorn,1,7000,7000,0,6500,500
02/14/25,Food,Snack,Almonds,1,8000,8000,0,7000,1000
02/14/25,Food,Beverages,Lemon Tea,5,4000,20000,0,15000,5000
02/14/25,Food,Beverages,Ocha,2,4000,8000,0,7000,1000
02/14/25,Food,Beverages,Lychee Tea,3,6000,18000,0,15000,3000
02/14/25,Food,Beverages,Oolong Tea,1,6000,6000,0,5000,1000
02/14/25,Food,Beverages,Soda,3,5000,15000,0,12000,3000
02/15/25,Food,Food,Takoyaki,3,10000,30000,0,24000,6000
02/15/25,Food,Food,Steak,4,60000,240000,0,220000,20000
02/15/25,Food,Food,Rendang,1,10000,10000,0,8000,2000
02/15/25,Food,Food,Fried Chicken,10,3000,30000,0,20000,10000
02/15/25,Food,Food,Noodles,8,6000,48000,0,40000,8000
02/15/25,Food,Food,Salmon,4,15000,60000,0,56000,4000
02/15/25,Food,Food,Macaroni,1,5000,5000,0,4000,1000
02/15/25,Food,Food,Fish & Chips,3,30000,90000,0,81000,9000
02/15/25,Food,Food,Burger,2,15000,30000,0,28000,2000
02/15/25,Food,Food,Hotdog,3,10000,30000,0,27000,3000
02/15/25,Food,Food,Pasta,1,18000,18000,0,16000,2000
02/15/25,Food,Snack,Chips,2,5000,10000,0,8000,2000
02/15/25,Food,Snack,Popcorn,1,7000,7000,0,6500,500
02/15/25,Food,Snack,Almonds,1,8000,8000,0,7000,1000
02/15/25,Food,Beverages,Lemon Tea,5,4000,20000,0,15000,5000
02/15/25,Food,Beverages,Ocha,2,4000,8000,0,7000,1000
02/15/25,Food,Beverages,Lychee Tea,3,6000,18000,0,15000,3000
02/15/25,Food,Beverages,Oolong Tea,1,6000,6000,0,5000,1000
02/15/25,Food,Beverages,Soda,3,5000,15000,0,12000,3000
02/16/25,Food,Food,Takoyaki,3,10000,30000,0,24000,6000
02/16/25,Food,Food,Steak,4,60000,240000,0,220000,20000
02/16/25,Food,Food,Rendang,1,10000,10000,0,8000,2000
02/16/25,Food,Food,Fried Chicken,10,3000,30000,0,20000,10000
02/16/25,Food,Food,Noodles,8,6000,48000,0,40000,8000
02/16/25,Food,Food,Salmon,4,15000,60000,0,56000,4000
02/16/25,Food,Food,Macaroni,1,5000,5000,0,4000,1000
02/16/25,Food,Food,Fish & Chips,3,30000,90000,0,81000,9000
02/16/25,Food,Food,Burger,2,15000,30000,0,28000,2000
02/16/25,Food,Food,Hotdog,3,10000,30000,0,27000,3000
02/16/25,Food,Food,Pasta,1,18000,18000,0,16000,2000
02/16/25,Food,Snack,Chips,2,5000,10000,0,8000,2000
02/16/25,Food,Snack,Popcorn,1,7000,7000,0,6500,500
02/16/25,Food,Snack,Almonds,1,8000,8000,0,7000,1000
02/16/25,Food,Beverages,Lemon Tea,5,4000,20000,0,15000,5000
02/16/25,Food,Beverages,Ocha,2,4000,8000,0,7000,1000
02/16/25,Food,Beverages,Lychee Tea,3,6000,18000,0,15000,3000
02/16/25,Food,Beverages,Oolong Tea,1,6000,6000,0,5000,1000
02/16/25,Food,Beverages,Soda,3,5000,15000,0,12000,3000
02/17/25,Food,Food,Takoyaki,3,10000,30000,0,24000,6000
02/17/25,Food,Food,Steak,4,60000,240000,0,220000,20000
02/17/25,Food,Food,Rendang,1,10000,10000,0,8000,2000
02/17/25,Food,Food,Fried Chicken,10,3000,30000,0,20000,10000
02/17/25,Food,Food,Noodles,8,6000,48000,0,40000,8000
02/17/25,Food,Food,Salmon,4,15000,60000,0,56000,4000
02/17/25,Food,Food,Macaroni,1,5000,5000,0,4000,1000
02/17/25,Food,Food,Fish & Chips,3,30000,90000,0,81000,9000
02/17/25,Food,Food,Burger,2,15000,30000,0,28000,2000
02/17/25,Food,Food,Hotdog,3,10000,30000,0,27000,3000
02/17/25,Food,Food,Pasta,1,18000,18000,0,16000,2000
02/17/25,Food,Snack,Chips,2,5000,10000,0,8000,2000
02/17/25,Food,Snack,Popcorn,1,7000,7000,0,6500,500
02/17/25,Food,Snack,Almonds,1,8000,8000,0,7000,1000
02/17/25,Food,Beverages,Lemon Tea,5,4000,20000,0,15000,5000
02/17/25,Food,Beverages,Ocha,2,4000,8000,0,7000,1000
02/17/25,Food,Beverages,Lychee Tea,3,6000,18000,0,15000,3000
02/17/25,Food,Beverages,Oolong Tea,1,6000,6000,0,5000,1000
02/17/25,Food,Beverages,Soda,3,5000,15000,0,12000,3000
02/18/25,Food,Food,Takoyaki,3,10000,30000,0,24000,6000
02/18/25,Food,Food,Steak,4,60000,240000,0,220000,20000
02/18/25,Food,Food,Rendang,1,10000,10000,0,8000,2000
02/18/25,Food,Food,Fried Chicken,10,3000,30000,0,20000,10000
02/18/25,Food,Food,Noodles,8,6000,48000,0,40000,8000
02/18/25,Food,Food,Salmon,4,15000,60000,0,56000,4000
02/18/25,Food,Food,Macaroni,1,5000,5000,0,4000,1000
02/18/25,Food,Food,Fish & Chips,3,30000,90000,0,81000,9000
02/18/25,Food,Food,Burger,2,15000,30000,0,28000,2000
02/18/25,Food,Food,Hotdog,3,10000,30000,0,27000,3000
02/18/25,Food,Food,Pasta,1,18000,18000,0,16000,2000
02/18/25,Food,Snack,Chips,2,5000,10000,0,8000,2000
02/18/25,Food,Snack,Popcorn,1,7000,7000,0,6500,500
02/18/25,Food,Snack,Almonds,1,8000,8000,0,7000,1000
02/18/25,Food,Beverages,Lemon Tea,5,4000,20000,0,15000,5000
02/18/25,Food,Beverages,Ocha,2,4000,8000,0,7000,1000
02/18/25,Food,Beverages,Lychee Tea,3,6000,18000,0,15000,3000
02/18/25,Food,Beverages,Oolong Tea,1,6000,6000,0,5000,1000
02/18/25,Food,Beverages,Soda,3,5000,15000,0,12000,3000
02/19/25,Food,Food,Takoyaki,3,10000,30000,0,24000,6000
02/19/25,Food,Food,Steak,4,60000,240000,0,220000,20000
02/19/25,Food,Food,Rendang,1,10000,10000,0,8000,2000
02/19/25,Food,Food,Fried Chicken,10,3000,30000,0,20000,10000
02/19/25,Food,Food,Noodles,8,6000,48000,0,40000,8000
02/19/25,Food,Food,Salmon,4,15000,60000,0,56000,4000
02/19/25,Food,Food,Macaroni,1,5000,5000,0,4000,1000
02/19/25,Food,Food,Fish & Chips,3,30000,90000,0,81000,9000
02/19/25,Food,Food,Burger,2,15000,30000,0,28000,2000
02/19/25,Food,Food,Hotdog,3,10000,30000,0,27000,3000
02/19/25,Food,Food,Pasta,1,18000,18000,0,16000,2000
02/19/25,Food,Snack,Chips,2,5000,10000,0,8000,2000
02/19/25,Food,Snack,Popcorn,1,7000,7000,0,6500,500
02/19/25,Food,Snack,Almonds,1,8000,8000,0,7000,1000
02/19/25,Food,Beverages,Lemon Tea,5,4000,20000,0,15000,5000
02/19/25,Food,Beverages,Ocha,2,4000,8000,0,7000,1000
02/19/25,Food,Beverages,Lychee Tea,3,6000,18000,0,15000,3000
02/19/25,Food,Beverages,Oolong Tea,1,6000,6000,0,5000,1000
02/19/25,Food,Beverages,Soda,3,5000,15000,0,12000,3000
02/20/25,Food,Food,Takoyaki,3,10000,30000,0,24000,6000
02/20/25,Food,Food,Steak,4,60000,240000,0,220000,20000
02/20/25,Food,Food,Rendang,1,10000,10000,0,8000,2000
02/20/25,Food,Food,Fried Chicken,10,3000,30000,0,20000,10000
02/20/25,Food,Food,Noodles,8,6000,48000,0,40000,8000
02/20/25,Food,Food,Salmon,4,15000,60000,0,56000,4000
02/20/25,Food,Food,Macaroni,1,5000,5000,0,4000,1000
02/20/25,Food,Food,Fish & Chips,3,30000,90000,0,81000,9000
02/20/25,Food,Food,Burger,2,15000,30000,0,28000,2000
02/20/25,Food,Food,Hotdog,3,10000,30000,0,27000,3000
02/20/25,Food,Food,Pasta,1,18000,18000,0,16000,2000
02/20/25,Food,Snack,Chips,2,5000,10000,0,8000,2000
02/20/25,Food,Snack,Popcorn,1,7000,7000,0,6500,500
02/20/25,Food,Snack,Almonds,1,8000,8000,0,7000,1000
02/20/25,Food,Beverages,Lemon Tea,5,4000,20000,0,15000,5000
02/20/25,Food,Beverages,Ocha,2,4000,8000,0,7000,1000
02/20/25,Food,Beverages,Lychee Tea,3,6000,18000,0,15000,3000
02/20/25,Food,Beverages,Oolong Tea,1,6000,6000,0,5000,1000
02/20/25,Food,Beverages,Soda,3,5000,15000,0,12000,3000
02/21/25,Food,Food,Takoyaki,3,10000,30000,0,24000,6000
02/21/25,Food,Food,Steak,4,60000,240000,0,220000,20000
02/21/25,Food,Food,Rendang,1,10000,10000,0,8000,2000
02/21/25,Food,Food,Fried Chicken,10,3000,30000,0,20000,10000
02/21/25,Food,Food,Noodles,8,6000,48000,0,40000,8000
02/21/25,Food,Food,Salmon,4,15000,60000,0,56000,4000
02/21/25,Food,Food,Macaroni,1,5000,5000,0,4000,1000
02/21/25,Food,Food,Fish & Chips,3,30000,90000,0,81000,9000
02/21/25,Food,Food,Burger,2,15000,30000,0,28000,2000
02/21/25,Food,Food,Hotdog,3,10000,30000,0,27000,3000
02/21/25,Food,Food,Pasta,1,18000,18000,0,16000,2000
02/21/25,Food,Snack,Chips,2,5000,10000,0,8000,2000
02/21/25,Food,Snack,Popcorn,1,7000,7000,0,6500,500
02/21/25,Food,Snack,Almonds,1,8000,8000,0,7000,1000
02/21/25,Food,Beverages,Lemon Tea,5,4000,20000,0,15000,5000
02/21/25,Food,Beverages,Ocha,2,4000,8000,0,7000,1000
02/21/25,Food,Beverages,Lychee Tea,3,6000,18000,0,15000,3000
02/21/25,Food,Beverages,Oolong Tea,1,6000,6000,0,5000,1000
02/21/25,Food,Beverages,Soda,3,5000,15000,0,12000,3000
02/22/25,Food,Food,Takoyaki,3,10000,30000,0,24000,6000
02/22/25,Food,Food,Steak,4,60000,240000,0,220000,20000
02/22/25,Food,Food,Rendang,1,10000,10000,0,8000,2000
02/22/25,Food,Food,Fried Chicken,10,3000,30000,0,20000,10000
02/22/25,Food,Food,Noodles,8,6000,48000,0,40000,8000
02/22/25,Food,Food,Salmon,4,15000,60000,0,56000,4000
02/22/25,Food,Food,Macaroni,1,5000,5000,0,4000,1000
02/22/25,Food,Food,Fish & Chips,3,30000,90000,0,81000,9000
02/22/25,Food,Food,Burger,2,15000,30000,0,28000,2000
02/22/25,Food,Food,Hotdog,3,10000,30000,0,27000,3000
02/22/25,Food,Food,Pasta,1,18000,18000,0,16000,2000
02/22/25,Food,Snack,Chips,2,5000,10000,0,8000,2000
02/22/25,Food,Snack,Popcorn,1,7000,7000,0,6500,500
02/22/25,Food,Snack,Almonds,1,8000,8000,0,7000,1000
02/22/25,Food,Beverages,Lemon Tea,5,4000,20000,0,15000,5000
02/22/25,Food,Beverages,Ocha,2,4000,8000,0,7000,1000
02/22/25,Food,Beverages,Lychee Tea,3,6000,18000,0,15000,3000
02/22/25,Food,Beverages,Oolong Tea,1,6000,6000,0,5000,1000
02/22/25,Food,Beverages,Soda,3,5000,15000,0,12000,3000
02/23/25,Food,Food,Takoyaki,3,10000,30000,0,24000,6000
02/23/25,Food,Food,Steak,4,60000,240000,0,220000,20000
02/23/25,Food,Food,Rendang,1,10000,10000,0,8000,2000
02/23/25,Food,Food,Fried Chicken,10,3000,30000,0,20000,10000
02/23/25,Food,Food,Noodles,8,6000,48000,0,40000,8000
02/23/25,Food,Food,Salmon,4,15000,60000,0,56000,4000
02/23/25,Food,Food,Macaroni,1,5000,5000,0,4000,1000
02/23/25,Food,Food,Fish & Chips,3,30000,90000,0,81000,9000
02/23/25,Food,Food,Burger,2,15000,30000,0,28000,2000
02/23/25,Food,Food,Hotdog,3,10000,30000,0,27000,3000
02/23/25,Food,Food,Pasta,1,18000,18000,0,16000,2000
02/23/25,Food,Snack,Chips,2,5000,10000,0,8000,2000
02/23/25,Food,Snack,Popcorn,1,7000,7000,0,6500,500
02/23/25,Food,Snack,Almonds,1,8000,8000,0,7000,1000
02/23/25,Food,Beverages,Lemon Tea,5,4000,20000,0,15000,5000
02/23/25,Food,Beverages,Ocha,2,4000,8000,0,7000,1000
02/23/25,Food,Beverages,Lychee Tea,3,6000,18000,0,15000,3000
02/23/25,Food,Beverages,Oolong Tea,1,6000,6000,0,5000,1000
02/23/25,Food,Beverages,Soda,3,5000,15000,0,12000,3000
02/24/25,Food,Food,Takoyaki,3,10000,30000,0,24000,6000
02/24/25,Food,Food,Steak,4,60000,240000,0,220000,20000
02/24/25,Food,Food,Rendang,1,10000,10000,0,8000,2000
02/24/25,Food,Food,Fried Chicken,10,3000,30000,0,20000,10000
02/24/25,Food,Food,Noodles,8,6000,48000,0,40000,8000
02/24/25,Food,Food,Salmon,4,15000,60000,0,56000,4000
02/24/25,Food,Food,Macaroni,1,5000,5000,0,4000,1000
02/24/25,Food,Food,Fish & Chips,3,30000,90000,0,81000,9000
02/24/25,Food,Food,Burger,2,15000,30000,0,28000,2000
02/24/25,Food,Food,Hotdog,3,10000,30000,0,27000,3000
02/24/25,Food,Food,Pasta,1,18000,18000,0,16000,2000
02/24/25,Food,Snack,Chips,2,5000,10000,0,8000,2000
02/24/25,Food,Snack,Popcorn,1,7000,7000,0,6500,500
02/24/25,Food,Snack,Almonds,1,8000,8000,0,7000,1000
02/24/25,Food,Beverages,Lemon Tea,5,4000,20000,0,15000,5000
02/24/25,Food,Beverages,Ocha,2,4000,8000,0,7000,1000
02/24/25,Food,Beverages,Lychee Tea,3,6000,18000,0,15000,3000
02/24/25,Food,Beverages,Oolong Tea,1,6000,6000,0,5000,1000
02/24/25,Food,Beverages,Soda,3,5000,15000,0,12000,3000
02/25/25,Food,Food,Takoyaki,3,10000,30000,0,24000,6000
02/25/25,Food,Food,Steak,4,60000,240000,0,220000,20000
02/25/25,Food,Food,Rendang,1,10000,10000,0,8000,2000
02/25/25,Food,Food,Fried Chicken,10,3000,30000,0,20000,10000
02/25/25,Food,Food,Noodles,8,6000,48000,0,40000,8000
02/25/25,Food,Food,Salmon,4,15000,60000,0,56000,4000
02/25/25,Food,Food,Macaroni,1,5000,5000,0,4000,1000
02/25/25,Food,Food,Fish & Chips,3,30000,90000,0,81000,9000
02/25/25,Food,Food,Burger,2,15000,30000,0,28000,2000
02/25/25,Food,Food,Hotdog,3,10000,30000,0,27000,3000
02/25/25,Food,Food,Pasta,1,18000,18000,0,16000,2000
02/25/25,Food,Snack,Chips,2,5000,10000,0,8000,2000
02/25/25,Food,Snack,Popcorn,1,7000,7000,0,6500,500
02/25/25,Food,Snack,Almonds,1,8000,8000,0,7000,1000
02/25/25,Food,Beverages,Lemon Tea,5,4000,20000,0,15000,5000
02/25/25,Food,Beverages,Ocha,2,4000,8000,0,7000,1000
02/25/25,Food,Beverages,Lychee Tea,3,6000,18000,0,15000,3000
02/25/25,Food,Beverages,Oolong Tea,1,6000,6000,0,5000,1000
02/25/25,Food,Beverages,Soda,3,5000,15000,0,12000,3000
02/26/25,Food,Food,Takoyaki,3,10000,30000,0,24000,6000
02/26/25,Food,Food,Steak,4,60000,240000,0,220000,20000
02/26/25,Food,Food,Rendang,1,10000,10000,0,8000,2000
02/26/25,Food,Food,Fried Chicken,10,3000,30000,0,20000,10000
02/26/25,Food,Food,Noodles,8,6000,48000,0,40000,8000
02/26/25,Food,Food,Salmon,4,15000,60000,0,56000,4000
02/26/25,Food,Food,Macaroni,1,5000,5000,0,4000,1000
02/26/25,Food,Food,Fish & Chips,3,30000,90000,0,81000,9000
02/26/25,Food,Food,Burger,2,15000,30000,0,28000,2000
02/26/25,Food,Food,Hotdog,3,10000,30000,0,27000,3000
02/26/25,Food,Food,Pasta,1,18000,18000,0,16000,2000
02/26/25,Food,Snack,Chips,2,5000,10000,0,8000,2000
02/26/25,Food,Snack,Popcorn,1,7000,7000,0,6500,500
02/26/25,Food,Snack,Almonds,1,8000,8000,0,7000,1000
02/26/25,Food,Beverages,Lemon Tea,5,4000,20000,0,15000,5000
02/26/25,Food,Beverages,Ocha,2,4000,8000,0,7000,1000
02/26/25,Food,Beverages,Lychee Tea,3,6000,18000,0,15000,3000
02/26/25,Food,Beverages,Oolong Tea,1,6000,6000,0,5000,1000
02/26/25,Food,Beverages,Soda,3,5000,15000,0,12000,3000
02/27/25,Food,Food,Takoyaki,3,10000,30000,0,24000,6000
02/27/25,Food,Food,Steak,4,60000,240000,0,220000,20000
02/27/25,Food,Food,Rendang,1,10000,10000,0,8000,2000
02/27/25,Food,Food,Fried Chicken,10,3000,30000,0,20000,10000
02/27/25,Food,Food,Noodles,8,6000,48000,0,40000,8000
02/27/25,Food,Food,Salmon,4,15000,60000,0,56000,4000
02/27/25,Food,Food,Macaroni,1,5000,5000,0,4000,1000
02/27/25,Food,Food,Fish & Chips,3,30000,90000,0,81000,9000
02/27/25,Food,Food,Burger,2,15000,30000,0,28000,2000
02/27/25,Food,Food,Hotdog,3,10000,30000,0,27000,3000
02/27/25,Food,Food,Pasta,1,18000,18000,0,16000,2000
02/27/25,Food,Snack,Chips,2,5000,10000,0,8000,2000
02/27/25,Food,Snack,Popcorn,1,7000,7000,0,6500,500
02/27/25,Food,Snack,Almonds,1,8000,8000,0,7000,1000
02/27/25,Food,Beverages,Lemon Tea,5,4000,20000,0,15000,5000
02/27/25,Food,Beverages,Ocha,2,4000,8000,0,7000,1000
02/27/25,Food,Beverages,Lychee Tea,3,6000,18000,0,15000,3000
02/27/25,Food,Beverages,Oolong Tea,1,6000,6000,0,5000,1000
02/27/25,Food,Beverages,Soda,3,5000,15000,0,12000,3000
02/28/25,Food,Food,Takoyaki,3,10000,30000,0,24000,6000
02/28/25,Food,Food,Steak,4,60000,240000,0,220000,20000
02/28/25,Food,Food,Rendang,1,10000,10000,0,8000,2000
02/28/25,Food,Food,Fried Chicken,10,3000,30000,0,20000,10000
02/28/25,Food,Food,Noodles,8,6000,48000,0,40000,8000
02/28/25,Food,Food,Salmon,4,15000,60000,0,56000,4000
02/28/25,Food,Food,Macaroni,1,5000,5000,0,4000,1000
02/28/25,Food,Food,Fish & Chips,3,30000,90000,0,81000,9000
02/28/25,Food,Food,Burger,2,15000,30000,0,28000,2000
02/28/25,Food,Food,Hotdog,3,10000,30000,0,27000,3000
02/28/25,Food,Food,Pasta,1,18000,18000,0,16000,2000
02/28/25,Food,Snack,Chips,2,5000,10000,0,8000,2000
02/28/25,Food,Snack,Popcorn,1,7000,7000,0,6500,500
02/28/25,Food,Snack,Almonds,1,8000,8000,0,7000,1000
02/28/25,Food,Beverages,Lemon Tea,5,4000,20000,0,15000,5000
02/28/25,Food,Beverages,Ocha,2,4000,8000,0,7000,1000
02/28/25,Food,Beverages,Lychee Tea,3,6000,18000,0,15000,3000
02/28/25,Food,Beverages,Oolong Tea,1,6000,6000,0,5000,1000
02/28/25,Food,Beverages,Soda,3,5000,15000,0,12000,3000
03/01/25,Food,Food,Takoyaki,3,10000,30000,0,24000,6000
03/01/25,Food,Food,Steak,4,60000,240000,0,220000,20000
03/01/25,Food,Food,Rendang,1,10000,10000,0,8000,2000
03/01/25,Food,Food,Fried Chicken,10,3000,30000,0,20000,10000
03/01/25,Food,Food,Noodles,8,6000,48000,0,40000,8000
03/01/25,Food,Food,Salmon,4,15000,60000,0,56000,4000
03/01/25,Food,Food,Macaroni,1,5000,5000,0,4000,1000
03/01/25,Food,Food,Fish & Chips,3,30000,90000,0,81000,9000
03/01/25,Food,Food,Burger,2,15000,30000,0,28000,2000
03/01/25,Food,Food,Hotdog,3,10000,30000,0,27000,3000
03/01/25,Food,Food,Pasta,1,18000,18000,0,16000,2000
03/01/25,Food,Snack,Chips,2,5000,10000,0,8000,2000
03/01/25,Food,Snack,Popcorn,1,7000,7000,0,6500,500
03/01/25,Food,Snack,Almonds,1,8000,8000,0,7000,1000
03/01/25,Food,Beverages,Lemon Tea,5,4000,20000,0,15000,5000
03/01/25,Food,Beverages,Ocha,2,4000,8000,0,7000,1000
03/01/25,Food,Beverages,Lychee Tea,3,6000,18000,0,15000,3000
03/01/25,Food,Beverages,Oolong Tea,1,6000,6000,0,5000,1000
03/01/25,Food,Beverages,Soda,3,5000,15000,0,12000,3000
03/02/25,Food,Food,Takoyaki,3,10000,30000,0,24000,6000
03/02/25,Food,Food,Steak,4,60000,240000,0,220000,20000
03/02/25,Food,Food,Rendang,1,10000,10000,0,8000,2000
03/02/25,Food,Food,Fried Chicken,10,3000,30000,0,20000,10000
03/02/25,Food,Food,Noodles,8,6000,48000,0,40000,8000
03/02/25,Food,Food,Salmon,4,15000,60000,0,56000,4000
03/02/25,Food,Food,Macaroni,1,5000,5000,0,4000,1000
03/02/25,Food,Food,Fish & Chips,3,30000,90000,0,81000,9000
03/02/25,Food,Food,Burger,2,15000,30000,0,28000,2000
03/02/25,Food,Food,Hotdog,3,10000,30000,0,27000,3000
03/02/25,Food,Food,Pasta,1,18000,18000,0,16000,2000
03/02/25,Food,Snack,Chips,2,5000,10000,0,8000,2000
03/02/25,Food,Snack,Popcorn,1,7000,7000,0,6500,500
03/02/25,Food,Snack,Almonds,1,8000,8000,0,7000,1000
03/02/25,Food,Beverages,Lemon Tea,5,4000,20000,0,15000,5000
03/02/25,Food,Beverages,Ocha,2,4000,8000,0,7000,1000
03/02/25,Food,Beverages,Lychee Tea,3,6000,18000,0,15000,3000
03/02/25,Food,Beverages,Oolong Tea,1,6000,6000,0,5000,1000
03/02/25,Food,Beverages,Soda,3,5000,15000,0,12000,3000
03/03/25,Food,Food,Takoyaki,3,10000,30000,0,24000,6000
03/03/25,Food,Food,Steak,4,60000,240000,0,220000,20000
03/03/25,Food,Food,Rendang,1,10000,10000,0,8000,2000
03/03/25,Food,Food,Fried Chicken,10,3000,30000,0,20000,10000
03/03/25,Food,Food,Noodles,8,6000,48000,0,40000,8000
03/03/25,Food,Food,Salmon,4,15000,60000,0,56000,4000
03/03/25,Food,Food,Macaroni,1,5000,5000,0,4000,1000
03/03/25,Food,Food,Fish & Chips,3,30000,90000,0,81000,9000
03/03/25,Food,Food,Burger,2,15000,30000,0,28000,2000
03/03/25,Food,Food,Hotdog,3,10000,30000,0,27000,3000
03/03/25,Food,Food,Pasta,1,18000,18000,0,16000,2000
03/03/25,Food,Snack,Chips,2,5000,10000,0,8000,2000
03/03/25,Food,Snack,Popcorn,1,7000,7000,0,6500,500
03/03/25,Food,Snack,Almonds,1,8000,8000,0,7000,1000
03/03/25,Food,Beverages,Lemon Tea,5,4000,20000,0,15000,5000
03/03/25,Food,Beverages,Ocha,2,4000,8000,0,7000,1000
03/03/25,Food,Beverages,Lychee Tea,3,6000,18000,0,15000,3000
03/03/25,Food,Beverages,Oolong Tea,1,6000,6000,0,5000,1000
03/03/25,Food,Beverages,Soda,3,5000,15000,0,12000,3000
03/04/25,Food,Food,Takoyaki,3,10000,30000,0,24000,6000
03/04/25,Food,Food,Steak,4,60000,240000,0,220000,20000
03/04/25,Food,Food,Rendang,1,10000,10000,0,8000,2000
03/04/25,Food,Food,Fried Chicken,10,3000,30000,0,20000,10000
03/04/25,Food,Food,Noodles,8,6000,48000,0,40000,8000
03/04/25,Food,Food,Salmon,4,15000,60000,0,56000,4000
03/04/25,Food,Food,Macaroni,1,5000,5000,0,4000,1000
03/04/25,Food,Food,Fish & Chips,3,30000,90000,0,81000,9000
03/04/25,Food,Food,Burger,2,15000,30000,0,28000,2000
03/04/25,Food,Food,Hotdog,3,10000,30000,0,27000,3000
03/04/25,Food,Food,Pasta,1,18000,18000,0,16000,2000
03/04/25,Food,Snack,Chips,2,5000,10000,0,8000,2000
03/04/25,Food,Snack,Popcorn,1,7000,7000,0,6500,500
03/04/25,Food,Snack,Almonds,1,8000,8000,0,7000,1000
03/04/25,Food,Beverages,Lemon Tea,5,4000,20000,0,15000,5000
03/04/25,Food,Beverages,Ocha,2,4000,8000,0,7000,1000
03/04/25,Food,Beverages,Lychee Tea,3,6000,18000,0,15000,3000
03/04/25,Food,Beverages,Oolong Tea,1,6000,6000,0,5000,1000
03/04/25,Food,Beverages,Soda,3,5000,15000,0,12000,3000
03/05/25,Food,Food,Takoyaki,3,10000,30000,0,24000,6000
03/05/25,Food,Food,Steak,4,60000,240000,0,220000,20000
03/05/25,Food,Food,Rendang,1,10000,10000,0,8000,2000
03/05/25,Food,Food,Fried Chicken,10,3000,30000,0,20000,10000
03/05/25,Food,Food,Noodles,8,6000,48000,0,40000,8000
03/05/25,Food,Food,Salmon,4,15000,60000,0,56000,4000
03/05/25,Food,Food,Macaroni,1,5000,5000,0,4000,1000
03/05/25,Food,Food,Fish & Chips,3,30000,90000,0,81000,9000
03/05/25,Food,Food,Burger,2,15000,30000,0,28000,2000
03/05/25,Food,Food,Hotdog,3,10000,30000,0,27000,3000
03/05/25,Food,Food,Pasta,1,18000,18000,0,16000,2000
03/05/25,Food,Snack,Chips,2,5000,10000,0,8000,2000
03/05/25,Food,Snack,Popcorn,1,7000,7000,0,6500,500
03/05/25,Food,Snack,Almonds,1,8000,8000,0,7000,1000
03/05/25,Food,Beverages,Lemon Tea,5,4000,20000,0,15000,5000
03/05/25,Food,Beverages,Ocha,2,4000,8000,0,7000,1000
03/05/25,Food,Beverages,Lychee Tea,3,6000,18000,0,15000,3000
03/05/25,Food,Beverages,Oolong Tea,1,6000,6000,0,5000,1000
03/05/25,Food,Beverages,Soda,3,5000,15000,0,12000,3000
03/06/25,Food,Food,Takoyaki,3,10000,30000,0,24000,6000
03/06/25,Food,Food,Steak,4,60000,240000,0,220000,20000
03/06/25,Food,Food,Rendang,1,10000,10000,0,8000,2000
03/06/25,Food,Food,Fried Chicken,10,3000,30000,0,20000,10000
03/06/25,Food,Food,Noodles,8,6000,48000,0,40000,8000
03/06/25,Food,Food,Salmon,4,15000,60000,0,56000,4000
03/06/25,Food,Food,Macaroni,1,5000,5000,0,4000,1000
03/06/25,Food,Food,Fish & Chips,3,30000,90000,0,81000,9000
03/06/25,Food,Food,Burger,2,15000,30000,0,28000,2000
03/06/25,Food,Food,Hotdog,3,10000,30000,0,27000,3000
03/06/25,Food,Food,Pasta,1,18000,18000,0,16000,2000
03/06/25,Food,Snack,Chips,2,5000,10000,0,8000,2000
03/06/25,Food,Snack,Popcorn,1,7000,7000,0,6500,500
03/06/25,Food,Snack,Almonds,1,8000,8000,0,7000,1000
03/06/25,Food,Beverages,Lemon Tea,5,4000,20000,0,15000,5000
03/06/25,Food,Beverages,Ocha,2,4000,8000,0,7000,1000
03/06/25,Food,Beverages,Lychee Tea,3,6000,18000,0,15000,3000
03/06/25,Food,Beverages,Oolong Tea,1,6000,6000,0,5000,1000
03/06/25,Food,Beverages,Soda,3,5000,15000,0,12000,3000
03/07/25,Food,Food,Takoyaki,3,10000,30000,0,24000,6000
03/07/25,Food,Food,Steak,4,60000,240000,0,220000,20000
03/07/25,Food,Food,Rendang,1,10000,10000,0,8000,2000
03/07/25,Food,Food,Fried Chicken,10,3000,30000,0,20000,10000
03/07/25,Food,Food,Noodles,8,6000,48000,0,40000,8000
03/07/25,Food,Food,Salmon,4,15000,60000,0,56000,4000
03/07/25,Food,Food,Macaroni,1,5000,5000,0,4000,1000
03/07/25,Food,Food,Fish & Chips,3,30000,90000,0,81000,9000
03/07/25,Food,Food,Burger,2,15000,30000,0,28000,2000
03/07/25,Food,Food,Hotdog,3,10000,30000,0,27000,3000
03/07/25,Food,Food,Pasta,1,18000,18000,0,16000,2000
03/07/25,Food,Snack,Chips,2,5000,10000,0,8000,2000
03/07/25,Food,Snack,Popcorn,1,7000,7000,0,6500,500
03/07/25,Food,Snack,Almonds,1,8000,8000,0,7000,1000
03/07/25,Food,Beverages,Lemon Tea,5,4000,20000,0,15000,5000
03/07/25,Food,Beverages,Ocha,2,4000,8000,0,7000,1000
03/07/25,Food,Beverages,Lychee Tea,3,6000,18000,0,15000,3000
03/07/25,Food,Beverages,Oolong Tea,1,6000,6000,0,5000,1000
03/07/25,Food,Beverages,Soda,3,5000,15000,0,12000,3000
03/08/25,Food,Food,Takoyaki,3,10000,30000,0,24000,6000
03/08/25,Food,Food,Steak,4,60000,240000,0,220000,20000
03/08/25,Food,Food,Rendang,1,10000,10000,0,8000,2000
03/08/25,Food,Food,Fried Chicken,10,3000,30000,0,20000,10000
03/08/25,Food,Food,Noodles,8,6000,48000,0,40000,8000
03/08/25,Food,Food,Salmon,4,15000,60000,0,56000,4000
03/08/25,Food,Food,Macaroni,1,5000,5000,0,4000,1000
03/08/25,Food,Food,Fish & Chips,3,30000,90000,0,81000,9000
03/08/25,Food,Food,Burger,2,15000,30000,0,28000,2000
03/08/25,Food,Food,Hotdog,3,10000,30000,0,27000,3000
03/08/25,Food,Food,Pasta,1,18000,18000,0,16000,2000
03/08/25,Food,Snack,Chips,2,5000,10000,0,8000,2000
03/08/25,Food,Snack,Popcorn,1,7000,7000,0,6500,500
03/08/25,Food,Snack,Almonds,1,8000,8000,0,7000,1000
03/08/25,Food,Beverages,Lemon Tea,5,4000,20000,0,15000,5000
03/08/25,Food,Beverages,Ocha,2,4000,8000,0,7000,1000
03/08/25,Food,Beverages,Lychee Tea,3,6000,18000,0,15000,3000
03/08/25,Food,Beverages,Oolong Tea,1,6000,6000,0,5000,1000
03/08/25,Food,Beverages,Soda,3,5000,15000,0,12000,3000
03/09/25,Food,Food,Takoyaki,3,10000,30000,0,24000,6000
03/09/25,Food,Food,Steak,4,60000,240000,0,220000,20000
03/09/25,Food,Food,Rendang,1,10000,10000,0,8000,2000
03/09/25,Food,Food,Fried Chicken,10,3000,30000,0,20000,10000
03/09/25,Food,Food,Noodles,8,6000,48000,0,40000,8000
03/09/25,Food,Food,Salmon,4,15000,60000,0,56000,4000
03/09/25,Food,Food,Macaroni,1,5000,5000,0,4000,1000
03/09/25,Food,Food,Fish & Chips,3,30000,90000,0,81000,9000
03/09/25,Food,Food,Burger,2,15000,30000,0,28000,2000
03/09/25,Food,Food,Hotdog,3,10000,30000,0,27000,3000
03/09/25,Food,Food,Pasta,1,18000,18000,0,16000,2000
03/09/25,Food,Snack,Chips,2,5000,10000,0,8000,2000
03/09/25,Food,Snack,Popcorn,1,7000,7000,0,6500,500
03/09/25,Food,Snack,Almonds,1,8000,8000,0,7000,1000
03/09/25,Food,Beverages,Lemon Tea,5,4000,20000,0,15000,5000
03/09/25,Food,Beverages,Ocha,2,4000,8000,0,7000,1000
03/09/25,Food,Beverages,Lychee Tea,3,6000,18000,0,15000,3000
03/09/25,Food,Beverages,Oolong Tea,1,6000,6000,0,5000,1000
03/09/25,Food,Beverages,Soda,3,5000,15000,0,12000,3000
03/10/25,Food,Food,Takoyaki,3,10000,30000,0,24000,6000
03/10/25,Food,Food,Steak,4,60000,240000,0,220000,20000
03/10/25,Food,Food,Rendang,1,10000,10000,0,8000,2000
03/10/25,Food,Food,Fried Chicken,10,3000,30000,0,20000,10000
03/10/25,Food,Food,Noodles,8,6000,48000,0,40000,8000
03/10/25,Food,Food,Salmon,4,15000,60000,0,56000,4000
03/10/25,Food,Food,Macaroni,1,5000,5000,0,4000,1000
03/10/25,Food,Food,Fish & Chips,3,30000,90000,0,81000,9000
03/10/25,Food,Food,Burger,2,15000,30000,0,28000,2000
03/10/25,Food,Food,Hotdog,3,10000,30000,0,27000,3000
03/10/25,Food,Food,Pasta,1,18000,18000,0,16000,2000
03/10/25,Food,Snack,Chips,2,5000,10000,0,8000,2000
03/10/25,Food,Snack,Popcorn,1,7000,7000,0,6500,500
03/10/25,Food,Snack,Almonds,1,8000,8000,0,7000,1000
03/10/25,Food,Beverages,Lemon Tea,5,4000,20000,0,15000,5000
03/10/25,Food,Beverages,Ocha,2,4000,8000,0,7000,1000
03/10/25,Food,Beverages,Lychee Tea,3,6000,18000,0,15000,3000
03/10/25,Food,Beverages,Oolong Tea,1,6000,6000,0,5000,1000
03/10/25,Food,Beverages,Soda,3,5000,15000,0,12000,3000
03/11/25,Food,Food,Takoyaki,3,10000,30000,0,24000,6000
03/11/25,Food,Food,Steak,4,60000,240000,0,220000,20000
03/11/25,Food,Food,Rendang,1,10000,10000,0,8000,2000
03/11/25,Food,Food,Fried Chicken,10,3000,30000,0,20000,10000
03/11/25,Food,Food,Noodles,8,6000,48000,0,40000,8000
03/11/25,Food,Food,Salmon,4,15000,60000,0,56000,4000
03/11/25,Food,Food,Macaroni,1,5000,5000,0,4000,1000
03/11/25,Food,Food,Fish & Chips,3,30000,90000,0,81000,9000
03/11/25,Food,Food,Burger,2,15000,30000,0,28000,2000
03/11/25,Food,Food,Hotdog,3,10000,30000,0,27000,3000
03/11/25,Food,Food,Pasta,1,18000,18000,0,16000,2000
03/11/25,Food,Snack,Chips,2,5000,10000,0,8000,2000
03/11/25,Food,Snack,Popcorn,1,7000,7000,0,6500,500
03/11/25,Food,Snack,Almonds,1,8000,8000,0,7000,1000
03/11/25,Food,Beverages,Lemon Tea,5,4000,20000,0,15000,5000
03/11/25,Food,Beverages,Ocha,2,4000,8000,0,7000,1000
03/11/25,Food,Beverages,Lychee Tea,3,6000,18000,0,15000,3000
03/11/25,Food,Beverages,Oolong Tea,1,6000,6000,0,5000,1000
03/11/25,Food,Beverages,Soda,3,5000,15000,0,12000,3000
03/12/25,Food,Food,Takoyaki,3,10000,30000,0,24000,6000
03/12/25,Food,Food,Steak,4,60000,240000,0,220000,20000
03/12/25,Food,Food,Rendang,1,10000,10000,0,8000,2000
03/12/25,Food,Food,Fried Chicken,10,3000,30000,0,20000,10000
03/12/25,Food,Food,Noodles,8,6000,48000,0,40000,8000
03/12/25,Food,Food,Salmon,4,15000,60000,0,56000,4000
03/12/25,Food,Food,Macaroni,1,5000,5000,0,4000,1000
03/12/25,Food,Food,Fish & Chips,3,30000,90000,0,81000,9000
03/12/25,Food,Food,Burger,2,15000,30000,0,28000,2000
03/12/25,Food,Food,Hotdog,3,10000,30000,0,27000,3000
03/12/25,Food,Food,Pasta,1,18000,18000,0,16000,2000
03/12/25,Food,Snack,Chips,2,5000,10000,0,8000,2000
03/12/25,Food,Snack,Popcorn,1,7000,7000,0,6500,500
03/12/25,Food,Snack,Almonds,1,8000,8000,0,7000,1000
03/12/25,Food,Beverages,Lemon Tea,5,4000,20000,0,15000,5000
03/12/25,Food,Beverages,Ocha,2,4000,8000,0,7000,1000
03/12/25,Food,Beverages,Lychee Tea,3,6000,18000,0,15000,3000
03/12/25,Food,Beverages,Oolong Tea,1,6000,6000,0,5000,1000
03/12/25,Food,Beverages,Soda,3,5000,15000,0,12000,3000
03/13/25,Food,Food,Takoyaki,3,10000,30000,0,24000,6000
03/13/25,Food,Food,Steak,4,60000,240000,0,220000,20000
03/13/25,Food,Food,Rendang,1,10000,10000,0,8000,2000
03/13/25,Food,Food,Fried Chicken,10,3000,30000,0,20000,10000
03/13/25,Food,Food,Noodles,8,6000,48000,0,40000,8000
03/13/25,Food,Food,Salmon,4,15000,60000,0,56000,4000
03/13/25,Food,Food,Macaroni,1,5000,5000,0,4000,1000
03/13/25,Food,Food,Fish & Chips,3,30000,90000,0,81000,9000
03/13/25,Food,Food,Burger,2,15000,30000,0,28000,2000
03/13/25,Food,Food,Hotdog,3,10000,30000,0,27000,3000
03/13/25,Food,Food,Pasta,1,18000,18000,0,16000,2000
03/13/25,Food,Snack,Chips,2,5000,10000,0,8000,2000
03/13/25,Food,Snack,Popcorn,1,7000,7000,0,6500,500
03/13/25,Food,Snack,Almonds,1,8000,8000,0,7000,1000
03/13/25,Food,Beverages,Lemon Tea,5,4000,20000,0,15000,5000
03/13/25,Food,Beverages,Ocha,2,4000,8000,0,7000,1000
03/13/25,Food,Beverages,Lychee Tea,3,6000,18000,0,15000,3000
03/13/25,Food,Beverages,Oolong Tea,1,6000,6000,0,5000,1000
03/13/25,Food,Beverages,Soda,3,5000,15000,0,12000,3000
03/14/25,Food,Food,Takoyaki,3,10000,30000,0,24000,6000
03/14/25,Food,Food,Steak,4,60000,240000,0,220000,20000
03/14/25,Food,Food,Rendang,1,10000,10000,0,8000,2000
03/14/25,Food,Food,Fried Chicken,10,3000,30000,0,20000,10000
03/14/25,Food,Food,Noodles,8,6000,48000,0,40000,8000
03/14/25,Food,Food,Salmon,4,15000,60000,0,56000,4000
03/14/25,Food,Food,Macaroni,1,5000,5000,0,4000,1000
03/14/25,Food,Food,Fish & Chips,3,30000,90000,0,81000,9000
03/14/25,Food,Food,Burger,2,15000,30000,0,28000,2000
03/14/25,Food,Food,Hotdog,3,10000,30000,0,27000,3000
03/14/25,Food,Food,Pasta,1,18000,18000,0,16000,2000
03/14/25,Food,Snack,Chips,2,5000,10000,0,8000,2000
03/14/25,Food,Snack,Popcorn,1,7000,7000,0,6500,500
03/14/25,Food,Snack,Almonds,1,8000,8000,0,7000,1000
03/14/25,Food,Beverages,Lemon Tea,5,4000,20000,0,15000,5000
03/14/25,Food,Beverages,Ocha,2,4000,8000,0,7000,1000
03/14/25,Food,Beverages,Lychee Tea,3,6000,18000,0,15000,3000
03/14/25,Food,Beverages,Oolong Tea,1,6000,6000,0,5000,1000
03/14/25,Food,Beverages,Soda,3,5000,15000,0,12000,3000
03/15/25,Food,Food,Takoyaki,3,10000,30000,0,24000,6000
03/15/25,Food,Food,Steak,4,60000,240000,0,220000,20000
03/15/25,Food,Food,Rendang,1,10000,10000,0,8000,2000
03/15/25,Food,Food,Fried Chicken,10,3000,30000,0,20000,10000
03/15/25,Food,Food,Noodles,8,6000,48000,0,40000,8000
03/15/25,Food,Food,Salmon,4,15000,60000,0,56000,4000
03/15/25,Food,Food,Macaroni,1,5000,5000,0,4000,1000
03/15/25,Food,Food,Fish & Chips,3,30000,90000,0,81000,9000
03/15/25,Food,Food,Burger,2,15000,30000,0,28000,2000
03/15/25,Food,Food,Hotdog,3,10000,30000,0,27000,3000
03/15/25,Food,Food,Pasta,1,18000,18000,0,16000,2000
03/15/25,Food,Snack,Chips,2,5000,10000,0,8000,2000
03/15/25,Food,Snack,Popcorn,1,7000,7000,0,6500,500
03/15/25,Food,Snack,Almonds,1,8000,8000,0,7000,1000
03/15/25,Food,Beverages,Lemon Tea,5,4000,20000,0,15000,5000
03/15/25,Food,Beverages,Ocha,2,4000,8000,0,7000,1000
03/15/25,Food,Beverages,Lychee Tea,3,6000,18000,0,15000,3000
03/15/25,Food,Beverages,Oolong Tea,1,6000,6000,0,5000,1000
03/15/25,Food,Beverages,Soda,3,5000,15000,0,12000,3000
03/16/25,Food,Food,Takoyaki,3,10000,30000,0,24000,6000
03/16/25,Food,Food,Steak,4,60000,240000,0,220000,20000
03/16/25,Food,Food,Rendang,1,10000,10000,0,8000,2000
03/16/25,Food,Food,Fried Chicken,10,3000,30000,0,20000,10000
03/16/25,Food,Food,Noodles,8,6000,48000,0,40000,8000
03/16/25,Food,Food,Salmon,4,15000,60000,0,56000,4000
03/16/25,Food,Food,Macaroni,1,5000,5000,0,4000,1000
03/16/25,Food,Food,Fish & Chips,3,30000,90000,0,81000,9000
03/16/25,Food,Food,Burger,2,15000,30000,0,28000,2000
03/16/25,Food,Food,Hotdog,3,10000,30000,0,27000,3000
03/16/25,Food,Food,Pasta,1,18000,18000,0,16000,2000
03/16/25,Food,Snack,Chips,2,5000,10000,0,8000,2000
03/16/25,Food,Snack,Popcorn,1,7000,7000,0,6500,500
03/16/25,Food,Snack,Almonds,1,8000,8000,0,7000,1000
03/16/25,Food,Beverages,Lemon Tea,5,4000,20000,0,15000,5000
03/16/25,Food,Beverages,Ocha,2,4000,8000,0,7000,1000
03/16/25,Food,Beverages,Lychee Tea,3,6000,18000,0,15000,3000
03/16/25,Food,Beverages,Oolong Tea,1,6000,6000,0,5000,1000
03/16/25,Food,Beverages,Soda,3,5000,15000,0,12000,3000
03/17/25,Food,Food,Takoyaki,3,10000,30000,0,24000,6000
03/17/25,Food,Food,Steak,4,60000,240000,0,220000,20000
03/17/25,Food,Food,Rendang,1,10000,10000,0,8000,2000
03/17/25,Food,Food,Fried Chicken,10,3000,30000,0,20000,10000
03/17/25,Food,Food,Noodles,8,6000,48000,0,40000,8000
03/17/25,Food,Food,Salmon,4,15000,60000,0,56000,4000
03/17/25,Food,Food,Macaroni,1,5000,5000,0,4000,1000
03/17/25,Food,Food,Fish & Chips,3,30000,90000,0,81000,9000
03/17/25,Food,Food,Burger,2,15000,30000,0,28000,2000
03/17/25,Food,Food,Hotdog,3,10000,30000,0,27000,3000
03/17/25,Food,Food,Pasta,1,18000,18000,0,16000,2000
03/17/25,Food,Snack,Chips,2,5000,10000,0,8000,2000
03/17/25,Food,Snack,Popcorn,1,7000,7000,0,6500,500
03/17/25,Food,Snack,Almonds,1,8000,8000,0,7000,1000
03/17/25,Food,Beverages,Lemon Tea,5,4000,20000,0,15000,5000
03/17/25,Food,Beverages,Ocha,2,4000,8000,0,7000,1000
03/17/25,Food,Beverages,Lychee Tea,3,6000,18000,0,15000,3000
03/17/25,Food,Beverages,Oolong Tea,1,6000,6000,0,5000,1000
03/17/25,Food,Beverages,Soda,3,5000,15000,0,12000,3000
03/18/25,Food,Food,Takoyaki,3,10000,30000,0,24000,6000
03/18/25,Food,Food,Steak,4,60000,240000,0,220000,20000
03/18/25,Food,Food,Rendang,1,10000,10000,0,8000,2000
03/18/25,Food,Food,Fried Chicken,10,3000,30000,0,20000,10000
03/18/25,Food,Food,Noodles,8,6000,48000,0,40000,8000
03/18/25,Food,Food,Salmon,4,15000,60000,0,56000,4000
03/18/25,Food,Food,Macaroni,1,5000,5000,0,4000,1000
03/18/25,Food,Food,Fish & Chips,3,30000,90000,0,81000,9000
03/18/25,Food,Food,Burger,2,15000,30000,0,28000,2000
03/18/25,Food,Food,Hotdog,3,10000,30000,0,27000,3000
03/18/25,Food,Food,Pasta,1,18000,18000,0,16000,2000
03/18/25,Food,Snack,Chips,2,5000,10000,0,8000,2000
03/18/25,Food,Snack,Popcorn,1,7000,7000,0,6500,500
03/18/25,Food,Snack,Almonds,1,8000,8000,0,7000,1000
03/18/25,Food,Beverages,Lemon Tea,5,4000,20000,0,15000,5000
03/18/25,Food,Beverages,Ocha,2,4000,8000,0,7000,1000
03/18/25,Food,Beverages,Lychee Tea,3,6000,18000,0,15000,3000
03/18/25,Food,Beverages,Oolong Tea,1,6000,6000,0,5000,1000
03/18/25,Food,Beverages,Soda,3,5000,15000,0,12000,3000
03/19/25,Food,Food,Takoyaki,3,10000,30000,0,24000,6000
03/19/25,Food,Food,Steak,4,60000,240000,0,220000,20000
03/19/25,Food,Food,Rendang,1,10000,10000,0,8000,2000
03/19/25,Food,Food,Fried Chicken,10,3000,30000,0,20000,10000
03/19/25,Food,Food,Noodles,8,6000,48000,0,40000,8000
03/19/25,Food,Food,Salmon,4,15000,60000,0,56000,4000
03/19/25,Food,Food,Macaroni,1,5000,5000,0,4000,1000
03/19/25,Food,Food,Fish & Chips,3,30000,90000,0,81000,9000
03/19/25,Food,Food,Burger,2,15000,30000,0,28000,2000
03/19/25,Food,Food,Hotdog,3,10000,30000,0,27000,3000
03/19/25,Food,Food,Pasta,1,18000,18000,0,16000,2000
03/19/25,Food,Snack,Chips,2,5000,10000,0,8000,2000
03/19/25,Food,Snack,Popcorn,1,7000,7000,0,6500,500
03/19/25,Food,Snack,Almonds,1,8000,8000,0,7000,1000
03/19/25,Food,Beverages,Lemon Tea,5,4000,20000,0,15000,5000
03/19/25,Food,Beverages,Ocha,2,4000,8000,0,7000,1000
03/19/25,Food,Beverages,Lychee Tea,3,6000,18000,0,15000,3000
03/19/25,Food,Beverages,Oolong Tea,1,6000,6000,0,5000,1000
03/19/25,Food,Beverages,Soda,3,5000,15000,0,12000,3000
03/20/25,Food,Food,Takoyaki,3,10000,30000,0,24000,6000
03/20/25,Food,Food,Steak,4,60000,240000,0,220000,20000
03/20/25,Food,Food,Rendang,1,10000,10000,0,8000,2000
03/20/25,Food,Food,Fried Chicken,10,3000,30000,0,20000,10000
03/20/25,Food,Food,Noodles,8,6000,48000,0,40000,8000
03/20/25,Food,Food,Salmon,4,15000,60000,0,56000,4000
03/20/25,Food,Food,Macaroni,1,5000,5000,0,4000,1000
03/20/25,Food,Food,Fish & Chips,3,30000,90000,0,81000,9000
03/20/25,Food,Food,Burger,2,15000,30000,0,28000,2000
03/20/25,Food,Food,Hotdog,3,10000,30000,0,27000,3000
03/20/25,Food,Food,Pasta,1,18000,18000,0,16000,2000
03/20/25,Food,Snack,Chips,2,5000,10000,0,8000,2000
03/20/25,Food,Snack,Popcorn,1,7000,7000,0,6500,500
03/20/25,Food,Snack,Almonds,1,8000,8000,0,7000,1000
03/20/25,Food,Beverages,Lemon Tea,5,4000,20000,0,15000,5000
03/20/25,Food,Beverages,Ocha,2,4000,8000,0,7000,1000
03/20/25,Food,Beverages,Lychee Tea,3,6000,18000,0,15000,3000
03/20/25,Food,Beverages,Oolong Tea,1,6000,6000,0,5000,1000
03/20/25,Food,Beverages,Soda,3,5000,15000,0,12000,3000
03/21/25,Food,Food,Takoyaki,3,10000,30000,0,24000,6000
03/21/25,Food,Food,Steak,4,60000,240000,0,220000,20000
03/21/25,Food,Food,Rendang,1,10000,10000,0,8000,2000
03/21/25,Food,Food,Fried Chicken,10,3000,30000,0,20000,10000
03/21/25,Food,Food,Noodles,8,6000,48000,0,40000,8000
03/21/25,Food,Food,Salmon,4,15000,60000,0,56000,4000
03/21/25,Food,Food,Macaroni,1,5000,5000,0,4000,1000
03/21/25,Food,Food,Fish & Chips,3,30000,90000,0,81000,9000
03/21/25,Food,Food,Burger,2,15000,30000,0,28000,2000
03/21/25,Food,Food,Hotdog,3,10000,30000,0,27000,3000
03/21/25,Food,Food,Pasta,1,18000,18000,0,16000,2000
03/21/25,Food,Snack,Chips,2,5000,10000,0,8000,2000
03/21/25,Food,Snack,Popcorn,1,7000,7000,0,6500,500
03/21/25,Food,Snack,Almonds,1,8000,8000,0,7000,1000
03/21/25,Food,Beverages,Lemon Tea,5,4000,20000,0,15000,5000
03/21/25,Food,Beverages,Ocha,2,4000,8000,0,7000,1000
03/21/25,Food,Beverages,Lychee Tea,3,6000,18000,0,15000,3000
03/21/25,Food,Beverages,Oolong Tea,1,6000,6000,0,5000,1000
03/21/25,Food,Beverages,Soda,3,5000,15000,0,12000,3000
03/22/25,Food,Food,Takoyaki,3,10000,30000,0,24000,6000
03/22/25,Food,Food,Steak,4,60000,240000,0,220000,20000
03/22/25,Food,Food,Rendang,1,10000,10000,0,8000,2000
03/22/25,Food,Food,Fried Chicken,10,3000,30000,0,20000,10000
03/22/25,Food,Food,Noodles,8,6000,48000,0,40000,8000
03/22/25,Food,Food,Salmon,4,15000,60000,0,56000,4000
03/22/25,Food,Food,Macaroni,1,5000,5000,0,4000,1000
03/22/25,Food,Food,Fish & Chips,3,30000,90000,0,81000,9000
03/22/25,Food,Food,Burger,2,15000,30000,0,28000,2000
03/22/25,Food,Food,Hotdog,3,10000,30000,0,27000,3000
03/22/25,Food,Food,Pasta,1,18000,18000,0,16000,2000
03/22/25,Food,Snack,Chips,2,5000,10000,0,8000,2000
03/22/25,Food,Snack,Popcorn,1,7000,7000,0,6500,500
03/22/25,Food,Snack,Almonds,1,8000,8000,0,7000,1000
03/22/25,Food,Beverages,Lemon Tea,5,4000,20000,0,15000,5000
03/22/25,Food,Beverages,Ocha,2,4000,8000,0,7000,1000
03/22/25,Food,Beverages,Lychee Tea,3,6000,18000,0,15000,3000
03/22/25,Food,Beverages,Oolong Tea,1,6000,6000,0,5000,1000
03/22/25,Food,Beverages,Soda,3,5000,15000,0,12000,3000
03/23/25,Food,Food,Takoyaki,3,10000,30000,0,24000,6000
03/23/25,Food,Food,Steak,4,60000,240000,0,220000,20000
03/23/25,Food,Food,Rendang,1,10000,10000,0,8000,2000
03/23/25,Food,Food,Fried Chicken,10,3000,30000,0,20000,10000
03/23/25,Food,Food,Noodles,8,6000,48000,0,40000,8000
03/23/25,Food,Food,Salmon,4,15000,60000,0,56000,4000
03/23/25,Food,Food,Macaroni,1,5000,5000,0,4000,1000
03/23/25,Food,Food,Fish & Chips,3,30000,90000,0,81000,9000
03/23/25,Food,Food,Burger,2,15000,30000,0,28000,2000
03/23/25,Food,Food,Hotdog,3,10000,30000,0,27000,3000
03/23/25,Food,Food,Pasta,1,18000,18000,0,16000,2000
03/23/25,Food,Snack,Chips,2,5000,10000,0,8000,2000
03/23/25,Food,Snack,Popcorn,1,7000,7000,0,6500,500
03/23/25,Food,Snack,Almonds,1,8000,8000,0,7000,1000
03/23/25,Food,Beverages,Lemon Tea,5,4000,20000,0,15000,5000
03/23/25,Food,Beverages,Ocha,2,4000,8000,0,7000,1000
03/23/25,Food,Beverages,Lychee Tea,3,6000,18000,0,15000,3000
03/23/25,Food,Beverages,Oolong Tea,1,6000,6000,0,5000,1000
03/23/25,Food,Beverages,Soda,3,5000,15000,0,12000,3000
03/24/25,Food,Food,Takoyaki,3,10000,30000,0,24000,6000
03/24/25,Food,Food,Steak,4,60000,240000,0,220000,20000
03/24/25,Food,Food,Rendang,1,10000,10000,0,8000,2000
03/24/25,Food,Food,Fried Chicken,10,3000,30000,0,20000,10000
03/24/25,Food,Food,Noodles,8,6000,48000,0,40000,8000
03/24/25,Food,Food,Salmon,4,15000,60000,0,56000,4000
03/24/25,Food,Food,Macaroni,1,5000,5000,0,4000,1000
03/24/25,Food,Food,Fish & Chips,3,30000,90000,0,81000,9000
03/24/25,Food,Food,Burger,2,15000,30000,0,28000,2000
03/24/25,Food,Food,Hotdog,3,10000,30000,0,27000,3000
03/24/25,Food,Food,Pasta,1,18000,18000,0,16000,2000
03/24/25,Food,Snack,Chips,2,5000,10000,0,8000,2000
03/24/25,Food,Snack,Popcorn,1,7000,7000,0,6500,500
03/24/25,Food,Snack,Almonds,1,8000,8000,0,7000,1000
03/24/25,Food,Beverages,Lemon Tea,5,4000,20000,0,15000,5000
03/24/25,Food,Beverages,Ocha,2,4000,8000,0,7000,1000
03/24/25,Food,Beverages,Lychee Tea,3,6000,18000,0,15000,3000
03/24/25,Food,Beverages,Oolong Tea,1,6000,6000,0,5000,1000
03/24/25,Food,Beverages,Soda,3,5000,15000,0,12000,3000
03/25/25,Food,Food,Takoyaki,3,10000,30000,0,24000,6000
03/25/25,Food,Food,Steak,4,60000,240000,0,220000,20000
03/25/25,Food,Food,Rendang,1,10000,10000,0,8000,2000
03/25/25,Food,Food,Fried Chicken,10,3000,30000,0,20000,10000
03/25/25,Food,Food,Noodles,8,6000,48000,0,40000,8000
03/25/25,Food,Food,Salmon,4,15000,60000,0,56000,4000
03/25/25,Food,Food,Macaroni,1,5000,5000,0,4000,1000
03/25/25,Food,Food,Fish & Chips,3,30000,90000,0,81000,9000
03/25/25,Food,Food,Burger,2,15000,30000,0,28000,2000
03/25/25,Food,Food,Hotdog,3,10000,30000,0,27000,3000
03/25/25,Food,Food,Pasta,1,18000,18000,0,16000,2000
03/25/25,Food,Snack,Chips,2,5000,10000,0,8000,2000
03/25/25,Food,Snack,Popcorn,1,7000,7000,0,6500,500
03/25/25,Food,Snack,Almonds,1,8000,8000,0,7000,1000
03/25/25,Food,Beverages,Lemon Tea,5,4000,20000,0,15000,5000
03/25/25,Food,Beverages,Ocha,2,4000,8000,0,7000,1000
03/25/25,Food,Beverages,Lychee Tea,3,6000,18000,0,15000,3000
03/25/25,Food,Beverages,Oolong Tea,1,6000,6000,0,5000,1000
03/25/25,Food,Beverages,Soda,3,5000,15000,0,12000,3000
03/26/25,Food,Food,Takoyaki,3,10000,30000,0,24000,6000
03/26/25,Food,Food,Steak,4,60000,240000,0,220000,20000
03/26/25,Food,Food,Rendang,1,10000,10000,0,8000,2000
03/26/25,Food,Food,Fried Chicken,10,3000,30000,0,20000,10000
03/26/25,Food,Food,Noodles,8,6000,48000,0,40000,8000
03/26/25,Food,Food,Salmon,4,15000,60000,0,56000,4000
03/26/25,Food,Food,Macaroni,1,5000,5000,0,4000,1000
03/26/25,Food,Food,Fish & Chips,3,30000,90000,0,81000,9000
03/26/25,Food,Food,Burger,2,15000,30000,0,28000,2000
03/26/25,Food,Food,Hotdog,3,10000,30000,0,27000,3000
03/26/25,Food,Food,Pasta,1,18000,18000,0,16000,2000
03/26/25,Food,Snack,Chips,2,5000,10000,0,8000,2000
03/26/25,Food,Snack,Popcorn,1,7000,7000,0,6500,500
03/26/25,Food,Snack,Almonds,1,8000,8000,0,7000,1000
03/26/25,Food,Beverages,Lemon Tea,5,4000,20000,0,15000,5000
03/26/25,Food,Beverages,Ocha,2,4000,8000,0,7000,1000
03/26/25,Food,Beverages,Lychee Tea,3,6000,18000,0,15000,3000
03/26/25,Food,Beverages,Oolong Tea,1,6000,6000,0,5000,1000
03/26/25,Food,Beverages,Soda,3,5000,15000,0,12000,3000
03/27/25,Food,Food,Takoyaki,3,10000,30000,0,24000,6000
03/27/25,Food,Food,Steak,4,60000,240000,0,220000,20000
03/27/25,Food,Food,Rendang,1,10000,10000,0,8000,2000
03/27/25,Food,Food,Fried Chicken,10,3000,30000,0,20000,10000
03/27/25,Food,Food,Noodles,8,6000,48000,0,40000,8000
03/27/25,Food,Food,Salmon,4,15000,60000,0,56000,4000
03/27/25,Food,Food,Macaroni,1,5000,5000,0,4000,1000
03/27/25,Food,Food,Fish & Chips,3,30000,90000,0,81000,9000
03/27/25,Food,Food,Burger,2,15000,30000,0,28000,2000
03/27/25,Food,Food,Hotdog,3,10000,30000,0,27000,3000
03/27/25,Food,Food,Pasta,1,18000,18000,0,16000,2000
03/27/25,Food,Snack,Chips,2,5000,10000,0,8000,2000
03/27/25,Food,Snack,Popcorn,1,7000,7000,0,6500,500
03/27/25,Food,Snack,Almonds,1,8000,8000,0,7000,1000
03/27/25,Food,Beverages,Lemon Tea,5,4000,20000,0,15000,5000
03/27/25,Food,Beverages,Ocha,2,4000,8000,0,7000,1000
03/27/25,Food,Beverages,Lychee Tea,3,6000,18000,0,15000,3000
03/27/25,Food,Beverages,Oolong Tea,1,6000,6000,0,5000,1000
03/27/25,Food,Beverages,Soda,3,5000,15000,0,12000,3000
03/28/25,Food,Food,Takoyaki,3,10000,30000,0,24000,6000
03/28/25,Food,Food,Steak,4,60000,240000,0,220000,20000
03/28/25,Food,Food,Rendang,1,10000,10000,0,8000,2000
03/28/25,Food,Food,Fried Chicken,10,3000,30000,0,20000,10000
03/28/25,Food,Food,Noodles,8,6000,48000,0,40000,8000
03/28/25,Food,Food,Salmon,4,15000,60000,0,56000,4000
03/28/25,Food,Food,Macaroni,1,5000,5000,0,4000,1000
03/28/25,Food,Food,Fish & Chips,3,30000,90000,0,81000,9000
03/28/25,Food,Food,Burger,2,15000,30000,0,28000,2000
03/28/25,Food,Food,Hotdog,3,10000,30000,0,27000,3000
03/28/25,Food,Food,Pasta,1,18000,18000,0,16000,2000
03/28/25,Food,Snack,Chips,2,5000,10000,0,8000,2000
03/28/25,Food,Snack,Popcorn,1,7000,7000,0,6500,500
03/28/25,Food,Snack,Almonds,1,8000,8000,0,7000,1000
03/28/25,Food,Beverages,Lemon Tea,5,4000,20000,0,15000,5000
03/28/25,Food,Beverages,Ocha,2,4000,8000,0,7000,1000
03/28/25,Food,Beverages,Lychee Tea,3,6000,18000,0,15000,3000
03/28/25,Food,Beverages,Oolong Tea,1,6000,6000,0,5000,1000
03/28/25,Food,Beverages,Soda,3,5000,15000,0,12000,3000
03/29/25,Food,Food,Takoyaki,3,10000,30000,0,24000,6000
03/29/25,Food,Food,Steak,4,60000,240000,0,220000,20000
03/29/25,Food,Food,Rendang,1,10000,10000,0,8000,2000
03/29/25,Food,Food,Fried Chicken,10,3000,30000,0,20000,10000
03/29/25,Food,Food,Noodles,8,6000,48000,0,40000,8000
03/29/25,Food,Food,Salmon,4,15000,60000,0,56000,4000
03/29/25,Food,Food,Macaroni,1,5000,5000,0,4000,1000
03/29/25,Food,Food,Fish & Chips,3,30000,90000,0,81000,9000
03/29/25,Food,Food,Burger,2,15000,30000,0,28000,2000
03/29/25,Food,Food,Hotdog,3,10000,30000,0,27000,3000
03/29/25,Food,Food,Pasta,1,18000,18000,0,16000,2000
03/29/25,Food,Snack,Chips,2,5000,10000,0,8000,2000
03/29/25,Food,Snack,Popcorn,1,7000,7000,0,6500,500
03/29/25,Food,Snack,Almonds,1,8000,8000,0,7000,1000
03/29/25,Food,Beverages,Lemon Tea,5,4000,20000,0,15000,5000
03/29/25,Food,Beverages,Ocha,2,4000,8000,0,7000,1000
03/29/25,Food,Beverages,Lychee Tea,3,6000,18000,0,15000,3000
03/29/25,Food,Beverages,Oolong Tea,1,6000,6000,0,5000,1000
03/29/25,Food,Beverages,Soda,3,5000,15000,0,12000,3000
03/30/25,Food,Food,Takoyaki,3,10000,30000,0,24000,6000
03/30/25,Food,Food,Steak,4,60000,240000,0,220000,20000
03/30/25,Food,Food,Rendang,1,10000,10000,0,8000,2000
03/30/25,Food,Food,Fried Chicken,10,3000,30000,0,20000,10000
03/30/25,Food,Food,Noodles,8,6000,48000,0,40000,8000
03/30/25,Food,Food,Salmon,4,15000,60000,0,56000,4000
03/30/25,Food,Food,Macaroni,1,5000,5000,0,4000,1000
03/30/25,Food,Food,Fish & Chips,3,30000,90000,0,81000,9000
03/30/25,Food,Food,Burger,2,15000,30000,0,28000,2000
03/30/25,Food,Food,Hotdog,3,10000,30000,0,27000,3000
03/30/25,Food,Food,Pasta,1,18000,18000,0,16000,2000
03/30/25,Food,Snack,Chips,2,5000,10000,0,8000,2000
03/30/25,Food,Snack,Popcorn,1,7000,7000,0,6500,500
03/30/25,Food,Snack,Almonds,1,8000,8000,0,7000,1000
03/30/25,Food,Beverages,Lemon Tea,5,4000,20000,0,15000,5000
03/30/25,Food,Beverages,Ocha,2,4000,8000,0,7000,1000
03/30/25,Food,Beverages,Lychee Tea,3,6000,18000,0,15000,3000
03/30/25,Food,Beverages,Oolong Tea,1,6000,6000,0,5000,1000
03/30/25,Food,Beverages,Soda,3,5000,15000,0,12000,3000
03/31/25,Food,Food,Takoyaki,3,10000,30000,0,24000,6000
03/31/25,Food,Food,Steak,4,60000,240000,0,220000,20000
03/31/25,Food,Food,Rendang,1,10000,10000,0,8000,2000
03/31/25,Food,Food,Fried Chicken,10,3000,30000,0,20000,10000
03/31/25,Food,Food,Noodles,8,6000,48000,0,40000,8000
03/31/25,Food,Food,Salmon,4,15000,60000,0,56000,4000
03/31/25,Food,Food,Macaroni,1,5000,5000,0,4000,1000
03/31/25,Food,Food,Fish & Chips,3,30000,90000,0,81000,9000
03/31/25,Food,Food,Burger,2,15000,30000,0,28000,2000
03/31/25,Food,Food,Hotdog,3,10000,30000,0,27000,3000
03/31/25,Food,Food,Pasta,1,18000,18000,0,16000,2000
03/31/25,Food,Snack,Chips,2,5000,10000,0,8000,2000
03/31/25,Food,Snack,Popcorn,1,7000,7000,0,6500,500
03/31/25,Food,Snack,Almonds,1,8000,8000,0,7000,1000
03/31/25,Food,Beverages,Lemon Tea,5,4000,20000,0,15000,5000
03/31/25,Food,Beverages,Ocha,2,4000,8000,0,7000,1000
03/31/25,Food,Beverages,Lychee Tea,3,6000,18000,0,15000,3000
03/31/25,Food,Beverages,Oolong Tea,1,6000,6000,0,5000,1000
03/31/25,Food,Beverages,Soda,3,5000,15000,0,12000,3000
04/01/25,Food,Food,Takoyaki,3,10000,30000,0,24000,6000
04/01/25,Food,Food,Steak,4,60000,240000,0,220000,20000
04/01/25,Food,Food,Rendang,1,10000,10000,0,8000,2000
04/01/25,Food,Food,Fried Chicken,10,3000,30000,0,20000,10000
04/01/25,Food,Food,Noodles,8,6000,48000,0,40000,8000
04/01/25,Food,Food,Salmon,4,15000,60000,0,56000,4000
04/01/25,Food,Food,Macaroni,1,5000,5000,0,4000,1000
04/01/25,Food,Food,Fish & Chips,3,30000,90000,0,81000,9000
04/01/25,Food,Food,Burger,2,15000,30000,0,28000,2000
04/01/25,Food,Food,Hotdog,3,10000,30000,0,27000,3000
04/01/25,Food,Food,Pasta,1,18000,18000,0,16000,2000
04/01/25,Food,Snack,Chips,2,5000,10000,0,8000,2000
04/01/25,Food,Snack,Popcorn,1,7000,7000,0,6500,500
04/01/25,Food,Snack,Almonds,1,8000,8000,0,7000,1000
04/01/25,Food,Beverages,Lemon Tea,5,4000,20000,0,15000,5000
04/01/25,Food,Beverages,Ocha,2,4000,8000,0,7000,1000
04/01/25,Food,Beverages,Lychee Tea,3,6000,18000,0,15000,3000
04/01/25,Food,Beverages,Oolong Tea,1,6000,6000,0,5000,1000
04/01/25,Food,Beverages,Soda,3,5000,15000,0,12000,3000
04/02/25,Food,Food,Takoyaki,3,10000,30000,0,24000,6000
04/02/25,Food,Food,Steak,4,60000,240000,0,220000,20000
04/02/25,Food,Food,Rendang,1,10000,10000,0,8000,2000
04/02/25,Food,Food,Fried Chicken,10,3000,30000,0,20000,10000
04/02/25,Food,Food,Noodles,8,6000,48000,0,40000,8000
04/02/25,Food,Food,Salmon,4,15000,60000,0,56000,4000
04/02/25,Food,Food,Macaroni,1,5000,5000,0,4000,1000
04/02/25,Food,Food,Fish & Chips,3,30000,90000,0,81000,9000
04/02/25,Food,Food,Burger,2,15000,30000,0,28000,2000
04/02/25,Food,Food,Hotdog,3,10000,30000,0,27000,3000
04/02/25,Food,Food,Pasta,1,18000,18000,0,16000,2000
04/02/25,Food,Snack,Chips,2,5000,10000,0,8000,2000
04/02/25,Food,Snack,Popcorn,1,7000,7000,0,6500,500
04/02/25,Food,Snack,Almonds,1,8000,8000,0,7000,1000
04/02/25,Food,Beverages,Lemon Tea,5,4000,20000,0,15000,5000
04/02/25,Food,Beverages,Ocha,2,4000,8000,0,7000,1000
04/02/25,Food,Beverages,Lychee Tea,3,6000,18000,0,15000,3000
04/02/25,Food,Beverages,Oolong Tea,1,6000,6000,0,5000,1000
04/02/25,Food,Beverages,Soda,3,5000,15000,0,12000,3000
04/03/25,Food,Food,Takoyaki,3,10000,30000,0,24000,6000
04/03/25,Food,Food,Steak,4,60000,240000,0,220000,20000
04/03/25,Food,Food,Rendang,1,10000,10000,0,8000,2000
04/03/25,Food,Food,Fried Chicken,10,3000,30000,0,20000,10000
04/03/25,Food,Food,Noodles,8,6000,48000,0,40000,8000
04/03/25,Food,Food,Salmon,4,15000,60000,0,56000,4000
04/03/25,Food,Food,Macaroni,1,5000,5000,0,4000,1000
04/03/25,Food,Food,Fish & Chips,3,30000,90000,0,81000,9000
04/03/25,Food,Food,Burger,2,15000,30000,0,28000,2000
04/03/25,Food,Food,Hotdog,3,10000,30000,0,27000,3000
04/03/25,Food,Food,Pasta,1,18000,18000,0,16000,2000
04/03/25,Food,Snack,Chips,2,5000,10000,0,8000,2000
04/03/25,Food,Snack,Popcorn,1,7000,7000,0,6500,500
04/03/25,Food,Snack,Almonds,1,8000,8000,0,7000,1000
04/03/25,Food,Beverages,Lemon Tea,5,4000,20000,0,15000,5000
04/03/25,Food,Beverages,Ocha,2,4000,8000,0,7000,1000
04/03/25,Food,Beverages,Lychee Tea,3,6000,18000,0,15000,3000
04/03/25,Food,Beverages,Oolong Tea,1,6000,6000,0,5000,1000
04/03/25,Food,Beverages,Soda,3,5000,15000,0,12000,3000
04/04/25,Food,Food,Takoyaki,3,10000,30000,0,24000,6000
04/04/25,Food,Food,Steak,4,60000,240000,0,220000,20000
04/04/25,Food,Food,Rendang,1,10000,10000,0,8000,2000
04/04/25,Food,Food,Fried Chicken,10,3000,30000,0,20000,10000
04/04/25,Food,Food,Noodles,8,6000,48000,0,40000,8000
04/04/25,Food,Food,Salmon,4,15000,60000,0,56000,4000
04/04/25,Food,Food,Macaroni,1,5000,5000,0,4000,1000
04/04/25,Food,Food,Fish & Chips,3,30000,90000,0,81000,9000
04/04/25,Food,Food,Burger,2,15000,30000,0,28000,2000
04/04/25,Food,Food,Hotdog,3,10000,30000,0,27000,3000
04/04/25,Food,Food,Pasta,1,18000,18000,0,16000,2000
04/04/25,Food,Snack,Chips,2,5000,10000,0,8000,2000
04/04/25,Food,Snack,Popcorn,1,7000,7000,0,6500,500
04/04/25,Food,Snack,Almonds,1,8000,8000,0,7000,1000
04/04/25,Food,Beverages,Lemon Tea,5,4000,20000,0,15000,5000
04/04/25,Food,Beverages,Ocha,2,4000,8000,0,7000,1000
04/04/25,Food,Beverages,Lychee Tea,3,6000,18000,0,15000,3000
04/04/25,Food,Beverages,Oolong Tea,1,6000,6000,0,5000,1000
04/04/25,Food,Beverages,Soda,3,5000,15000,0,12000,3000
04/05/25,Food,Food,Takoyaki,3,10000,30000,0,24000,6000
04/05/25,Food,Food,Steak,4,60000,240000,0,220000,20000
04/05/25,Food,Food,Rendang,1,10000,10000,0,8000,2000
04/05/25,Food,Food,Fried Chicken,10,3000,30000,0,20000,10000
04/05/25,Food,Food,Noodles,8,6000,48000,0,40000,8000
04/05/25,Food,Food,Salmon,4,15000,60000,0,56000,4000
04/05/25,Food,Food,Macaroni,1,5000,5000,0,4000,1000
04/05/25,Food,Food,Fish & Chips,3,30000,90000,0,81000,9000
04/05/25,Food,Food,Burger,2,15000,30000,0,28000,2000
04/05/25,Food,Food,Hotdog,3,10000,30000,0,27000,3000
04/05/25,Food,Food,Pasta,1,18000,18000,0,16000,2000
04/05/25,Food,Snack,Chips,2,5000,10000,0,8000,2000
04/05/25,Food,Snack,Popcorn,1,7000,7000,0,6500,500
04/05/25,Food,Snack,Almonds,1,8000,8000,0,7000,1000
04/05/25,Food,Beverages,Lemon Tea,5,4000,20000,0,15000,5000
04/05/25,Food,Beverages,Ocha,2,4000,8000,0,7000,1000
04/05/25,Food,Beverages,Lychee Tea,3,6000,18000,0,15000,3000
04/05/25,Food,Beverages,Oolong Tea,1,6000,6000,0,5000,1000
04/05/25,Food,Beverages,Soda,3,5000,15000,0,12000,3000
04/06/25,Food,Food,Takoyaki,3,10000,30000,0,24000,6000
04/06/25,Food,Food,Steak,4,60000,240000,0,220000,20000
04/06/25,Food,Food,Rendang,1,10000,10000,0,8000,2000
04/06/25,Food,Food,Fried Chicken,10,3000,30000,0,20000,10000
04/06/25,Food,Food,Noodles,8,6000,48000,0,40000,8000
04/06/25,Food,Food,Salmon,4,15000,60000,0,56000,4000
04/06/25,Food,Food,Macaroni,1,5000,5000,0,4000,1000
04/06/25,Food,Food,Fish & Chips,3,30000,90000,0,81000,9000
04/06/25,Food,Food,Burger,2,15000,30000,0,28000,2000
04/06/25,Food,Food,Hotdog,3,10000,30000,0,27000,3000
04/06/25,Food,Food,Pasta,1,18000,18000,0,16000,2000
04/06/25,Food,Snack,Chips,2,5000,10000,0,8000,2000
04/06/25,Food,Snack,Popcorn,1,7000,7000,0,6500,500
04/06/25,Food,Snack,Almonds,1,8000,8000,0,7000,1000
04/06/25,Food,Beverages,Lemon Tea,5,4000,20000,0,15000,5000
04/06/25,Food,Beverages,Ocha,2,4000,8000,0,7000,1000
04/06/25,Food,Beverages,Lychee Tea,3,6000,18000,0,15000,3000
04/06/25,Food,Beverages,Oolong Tea,1,6000,6000,0,5000,1000
04/06/25,Food,Beverages,Soda,3,5000,15000,0,12000,3000
04/07/25,Food,Food,Takoyaki,3,10000,30000,0,24000,6000
04/07/25,Food,Food,Steak,4,60000,240000,0,220000,20000
04/07/25,Food,Food,Rendang,1,10000,10000,0,8000,2000
04/07/25,Food,Food,Fried Chicken,10,3000,30000,0,20000,10000
04/07/25,Food,Food,Noodles,8,6000,48000,0,40000,8000
04/07/25,Food,Food,Salmon,4,15000,60000,0,56000,4000
04/07/25,Food,Food,Macaroni,1,5000,5000,0,4000,1000
04/07/25,Food,Food,Fish & Chips,3,30000,90000,0,81000,9000
04/07/25,Food,Food,Burger,2,15000,30000,0,28000,2000
04/07/25,Food,Food,Hotdog,3,10000,30000,0,27000,3000
04/07/25,Food,Food,Pasta,1,18000,18000,0,16000,2000
04/07/25,Food,Snack,Chips,2,5000,10000,0,8000,2000
04/07/25,Food,Snack,Popcorn,1,7000,7000,0,6500,500
04/07/25,Food,Snack,Almonds,1,8000,8000,0,7000,1000
04/07/25,Food,Beverages,Lemon Tea,5,4000,20000,0,15000,5000
04/07/25,Food,Beverages,Ocha,2,4000,8000,0,7000,1000
04/07/25,Food,Beverages,Lychee Tea,3,6000,18000,0,15000,3000
04/07/25,Food,Beverages,Oolong Tea,1,6000,6000,0,5000,1000
04/07/25,Food,Beverages,Soda,3,5000,15000,0,12000,3000
04/08/25,Food,Food,Takoyaki,3,10000,30000,0,24000,6000
04/08/25,Food,Food,Steak,4,60000,240000,0,220000,20000
04/08/25,Food,Food,Rendang,1,10000,10000,0,8000,2000
04/08/25,Food,Food,Fried Chicken,10,3000,30000,0,20000,10000
04/08/25,Food,Food,Noodles,8,6000,48000,0,40000,8000
04/08/25,Food,Food,Salmon,4,15000,60000,0,56000,4000
04/08/25,Food,Food,Macaroni,1,5000,5000,0,4000,1000
04/08/25,Food,Food,Fish & Chips,3,30000,90000,0,81000,9000
04/08/25,Food,Food,Burger,2,15000,30000,0,28000,2000
04/08/25,Food,Food,Hotdog,3,10000,30000,0,27000,3000
04/08/25,Food,Food,Pasta,1,18000,18000,0,16000,2000
04/08/25,Food,Snack,Chips,2,5000,10000,0,8000,2000
04/08/25,Food,Snack,Popcorn,1,7000,7000,0,6500,500
04/08/25,Food,Snack,Almonds,1,8000,8000,0,7000,1000
04/08/25,Food,Beverages,Lemon Tea,5,4000,20000,0,15000,5000
04/08/25,Food,Beverages,Ocha,2,4000,8000,0,7000,1000
04/08/25,Food,Beverages,Lychee Tea,3,6000,18000,0,15000,3000
04/08/25,Food,Beverages,Oolong Tea,1,6000,6000,0,5000,1000
04/08/25,Food,Beverages,Soda,3,5000,15000,0,12000,3000
04/09/25,Food,Food,Takoyaki,3,10000,30000,0,24000,6000
04/09/25,Food,Food,Steak,4,60000,240000,0,220000,20000
04/09/25,Food,Food,Rendang,1,10000,10000,0,8000,2000
04/09/25,Food,Food,Fried Chicken,10,3000,30000,0,20000,10000
04/09/25,Food,Food,Noodles,8,6000,48000,0,40000,8000
04/09/25,Food,Food,Salmon,4,15000,60000,0,56000,4000
04/09/25,Food,Food,Macaroni,1,5000,5000,0,4000,1000
04/09/25,Food,Food,Fish & Chips,3,30000,90000,0,81000,9000
04/09/25,Food,Food,Burger,2,15000,30000,0,28000,2000
04/09/25,Food,Food,Hotdog,3,10000,30000,0,27000,3000
04/09/25,Food,Food,Pasta,1,18000,18000,0,16000,2000
04/09/25,Food,Snack,Chips,2,5000,10000,0,8000,2000
04/09/25,Food,Snack,Popcorn,1,7000,7000,0,6500,500
04/09/25,Food,Snack,Almonds,1,8000,8000,0,7000,1000
04/09/25,Food,Beverages,Lemon Tea,5,4000,20000,0,15000,5000
04/09/25,Food,Beverages,Ocha,2,4000,8000,0,7000,1000
04/09/25,Food,Beverages,Lychee Tea,3,6000,18000,0,15000,3000
04/09/25,Food,Beverages,Oolong Tea,1,6000,6000,0,5000,1000
04/09/25,Food,Beverages,Soda,3,5000,15000,0,12000,3000
04/10/25,Food,Food,Takoyaki,3,10000,30000,0,24000,6000
04/10/25,Food,Food,Steak,4,60000,240000,0,220000,20000
04/10/25,Food,Food,Rendang,1,10000,10000,0,8000,2000
04/10/25,Food,Food,Fried Chicken,10,3000,30000,0,20000,10000
04/10/25,Food,Food,Noodles,8,6000,48000,0,40000,8000
04/10/25,Food,Food,Salmon,4,15000,60000,0,56000,4000
04/10/25,Food,Food,Macaroni,1,5000,5000,0,4000,1000
04/10/25,Food,Food,Fish & Chips,3,30000,90000,0,81000,9000
04/10/25,Food,Food,Burger,2,15000,30000,0,28000,2000
04/10/25,Food,Food,Hotdog,3,10000,30000,0,27000,3000
04/10/25,Food,Food,Pasta,1,18000,18000,0,16000,2000
04/10/25,Food,Snack,Chips,2,5000,10000,0,8000,2000
04/10/25,Food,Snack,Popcorn,1,7000,7000,0,6500,500
04/10/25,Food,Snack,Almonds,1,8000,8000,0,7000,1000
04/10/25,Food,Beverages,Lemon Tea,5,4000,20000,0,15000,5000
04/10/25,Food,Beverages,Ocha,2,4000,8000,0,7000,1000
04/10/25,Food,Beverages,Lychee Tea,3,6000,18000,0,15000,3000
04/10/25,Food,Beverages,Oolong Tea,1,6000,6000,0,5000,1000
04/10/25,Food,Beverages,Soda,3,5000,15000,0,12000,3000
04/11/25,Food,Food,Takoyaki,3,10000,30000,0,24000,6000
04/11/25,Food,Food,Steak,4,60000,240000,0,220000,20000
04/11/25,Food,Food,Rendang,1,10000,10000,0,8000,2000
04/11/25,Food,Food,Fried Chicken,10,3000,30000,0,20000,10000
04/11/25,Food,Food,Noodles,8,6000,48000,0,40000,8000
04/11/25,Food,Food,Salmon,4,15000,60000,0,56000,4000
04/11/25,Food,Food,Macaroni,1,5000,5000,0,4000,1000
04/11/25,Food,Food,Fish & Chips,3,30000,90000,0,81000,9000
04/11/25,Food,Food,Burger,2,15000,30000,0,28000,2000
04/11/25,Food,Food,Hotdog,3,10000,30000,0,27000,3000
04/11/25,Food,Food,Pasta,1,18000,18000,0,16000,2000
04/11/25,Food,Snack,Chips,2,5000,10000,0,8000,2000
04/11/25,Food,Snack,Popcorn,1,7000,7000,0,6500,500
04/11/25,Food,Snack,Almonds,1,8000,8000,0,7000,1000
04/11/25,Food,Beverages,Lemon Tea,5,4000,20000,0,15000,5000
04/11/25,Food,Beverages,Ocha,2,4000,8000,0,7000,1000
04/11/25,Food,Beverages,Lychee Tea,3,6000,18000,0,15000,3000
04/11/25,Food,Beverages,Oolong Tea,1,6000,6000,0,5000,1000
04/11/25,Food,Beverages,Soda,3,5000,15000,0,12000,3000
04/12/25,Food,Food,Takoyaki,3,10000,30000,0,24000,6000
04/12/25,Food,Food,Steak,4,60000,240000,0,220000,20000
04/12/25,Food,Food,Rendang,1,10000,10000,0,8000,2000
04/12/25,Food,Food,Fried Chicken,10,3000,30000,0,20000,10000
04/12/25,Food,Food,Noodles,8,6000,48000,0,40000,8000
04/12/25,Food,Food,Salmon,4,15000,60000,0,56000,4000
04/12/25,Food,Food,Macaroni,1,5000,5000,0,4000,1000
04/12/25,Food,Food,Fish & Chips,3,30000,90000,0,81000,9000
04/12/25,Food,Food,Burger,2,15000,30000,0,28000,2000
04/12/25,Food,Food,Hotdog,3,10000,30000,0,27000,3000
04/12/25,Food,Food,Pasta,1,18000,18000,0,16000,2000
04/12/25,Food,Snack,Chips,2,5000,10000,0,8000,2000
04/12/25,Food,Snack,Popcorn,1,7000,7000,0,6500,500
04/12/25,Food,Snack,Almonds,1,8000,8000,0,7000,1000
04/12/25,Food,Beverages,Lemon Tea,5,4000,20000,0,15000,5000
04/12/25,Food,Beverages,Ocha,2,4000,8000,0,7000,1000
04/12/25,Food,Beverages,Lychee Tea,3,6000,18000,0,15000,3000
04/12/25,Food,Beverages,Oolong Tea,1,6000,6000,0,5000,1000
04/12/25,Food,Beverages,Soda,3,5000,15000,0,12000,3000
04/13/25,Food,Food,Takoyaki,3,10000,30000,0,24000,6000
04/13/25,Food,Food,Steak,4,60000,240000,0,220000,20000
04/13/25,Food,Food,Rendang,1,10000,10000,0,8000,2000
04/13/25,Food,Food,Fried Chicken,10,3000,30000,0,20000,10000
04/13/25,Food,Food,Noodles,8,6000,48000,0,40000,8000
04/13/25,Food,Food,Salmon,4,15000,60000,0,56000,4000
04/13/25,Food,Food,Macaroni,1,5000,5000,0,4000,1000
04/13/25,Food,Food,Fish & Chips,3,30000,90000,0,81000,9000
04/13/25,Food,Food,Burger,2,15000,30000,0,28000,2000
04/13/25,Food,Food,Hotdog,3,10000,30000,0,27000,3000
04/13/25,Food,Food,Pasta,1,18000,18000,0,16000,2000
04/13/25,Food,Snack,Chips,2,5000,10000,0,8000,2000
04/13/25,Food,Snack,Popcorn,1,7000,7000,0,6500,500
04/13/25,Food,Snack,Almonds,1,8000,8000,0,7000,1000
04/13/25,Food,Beverages,Lemon Tea,5,4000,20000,0,15000,5000
04/13/25,Food,Beverages,Ocha,2,4000,8000,0,7000,1000
04/13/25,Food,Beverages,Lychee Tea,3,6000,18000,0,15000,3000
04/13/25,Food,Beverages,Oolong Tea,1,6000,6000,0,5000,1000
04/13/25,Food,Beverages,Soda,3,5000,15000,0,12000,3000
04/14/25,Food,Food,Takoyaki,3,10000,30000,0,24000,6000
04/14/25,Food,Food,Steak,4,60000,240000,0,220000,20000
04/14/25,Food,Food,Rendang,1,10000,10000,0,8000,2000
04/14/25,Food,Food,Fried Chicken,10,3000,30000,0,20000,10000
04/14/25,Food,Food,Noodles,8,6000,48000,0,40000,8000
04/14/25,Food,Food,Salmon,4,15000,60000,0,56000,4000
04/14/25,Food,Food,Macaroni,1,5000,5000,0,4000,1000
04/14/25,Food,Food,Fish & Chips,3,30000,90000,0,81000,9000
04/14/25,Food,Food,Burger,2,15000,30000,0,28000,2000
04/14/25,Food,Food,Hotdog,3,10000,30000,0,27000,3000
04/14/25,Food,Food,Pasta,1,18000,18000,0,16000,2000
04/14/25,Food,Snack,Chips,2,5000,10000,0,8000,2000
04/14/25,Food,Snack,Popcorn,1,7000,7000,0,6500,500
04/14/25,Food,Snack,Almonds,1,8000,8000,0,7000,1000
04/14/25,Food,Beverages,Lemon Tea,5,4000,20000,0,15000,5000
04/14/25,Food,Beverages,Ocha,2,4000,8000,0,7000,1000
04/14/25,Food,Beverages,Lychee Tea,3,6000,18000,0,15000,3000
04/14/25,Food,Beverages,Oolong Tea,1,6000,6000,0,5000,1000
04/14/25,Food,Beverages,Soda,3,5000,15000,0,12000,3000
04/15/25,Food,Food,Takoyaki,3,10000,30000,0,24000,6000
04/15/25,Food,Food,Steak,4,60000,240000,0,220000,20000
04/15/25,Food,Food,Rendang,1,10000,10000,0,8000,2000
04/15/25,Food,Food,Fried Chicken,10,3000,30000,0,20000,10000
04/15/25,Food,Food,Noodles,8,6000,48000,0,40000,8000
04/15/25,Food,Food,Salmon,4,15000,60000,0,56000,4000
04/15/25,Food,Food,Macaroni,1,5000,5000,0,4000,1000
04/15/25,Food,Food,Fish & Chips,3,30000,90000,0,81000,9000
04/15/25,Food,Food,Burger,2,15000,30000,0,28000,2000
04/15/25,Food,Food,Hotdog,3,10000,30000,0,27000,3000
04/15/25,Food,Food,Pasta,1,18000,18000,0,16000,2000
04/15/25,Food,Snack,Chips,2,5000,10000,0,8000,2000
04/15/25,Food,Snack,Popcorn,1,7000,7000,0,6500,500
04/15/25,Food,Snack,Almonds,1,8000,8000,0,7000,1000
04/15/25,Food,Beverages,Lemon Tea,5,4000,20000,0,15000,5000
04/15/25,Food,Beverages,Ocha,2,4000,8000,0,7000,1000
04/15/25,Food,Beverages,Lychee Tea,3,6000,18000,0,15000,3000
04/15/25,Food,Beverages,Oolong Tea,1,6000,6000,0,5000,1000
04/15/25,Food,Beverages,Soda,3,5000,15000,0,12000,3000
04/16/25,Food,Food,Takoyaki,3,10000,30000,0,24000,6000
04/16/25,Food,Food,Steak,4,60000,240000,0,220000,20000
04/16/25,Food,Food,Rendang,1,10000,10000,0,8000,2000
04/16/25,Food,Food,Fried Chicken,10,3000,30000,0,20000,10000
04/16/25,Food,Food,Noodles,8,6000,48000,0,40000,8000
04/16/25,Food,Food,Salmon,4,15000,60000,0,56000,4000
04/16/25,Food,Food,Macaroni,1,5000,5000,0,4000,1000
04/16/25,Food,Food,Fish & Chips,3,30000,90000,0,81000,9000
04/16/25,Food,Food,Burger,2,15000,30000,0,28000,2000
04/16/25,Food,Food,Hotdog,3,10000,30000,0,27000,3000
04/16/25,Food,Food,Pasta,1,18000,18000,0,16000,2000
04/16/25,Food,Snack,Chips,2,5000,10000,0,8000,2000
04/16/25,Food,Snack,Popcorn,1,7000,7000,0,6500,500
04/16/25,Food,Snack,Almonds,1,8000,8000,0,7000,1000
04/16/25,Food,Beverages,Lemon Tea,5,4000,20000,0,15000,5000
04/16/25,Food,Beverages,Ocha,2,4000,8000,0,7000,1000
04/16/25,Food,Beverages,Lychee Tea,3,6000,18000,0,15000,3000
04/16/25,Food,Beverages,Oolong Tea,1,6000,6000,0,5000,1000
04/16/25,Food,Beverages,Soda,3,5000,15000,0,12000,3000
04/17/25,Food,Food,Takoyaki,3,10000,30000,0,24000,6000
04/17/25,Food,Food,Steak,4,60000,240000,0,220000,20000
04/17/25,Food,Food,Rendang,1,10000,10000,0,8000,2000
04/17/25,Food,Food,Fried Chicken,10,3000,30000,0,20000,10000
04/17/25,Food,Food,Noodles,8,6000,48000,0,40000,8000
04/17/25,Food,Food,Salmon,4,15000,60000,0,56000,4000
04/17/25,Food,Food,Macaroni,1,5000,5000,0,4000,1000
04/17/25,Food,Food,Fish & Chips,3,30000,90000,0,81000,9000
04/17/25,Food,Food,Burger,2,15000,30000,0,28000,2000
04/17/25,Food,Food,Hotdog,3,10000,30000,0,27000,3000
04/17/25,Food,Food,Pasta,1,18000,18000,0,16000,2000
04/17/25,Food,Snack,Chips,2,5000,10000,0,8000,2000
04/17/25,Food,Snack,Popcorn,1,7000,7000,0,6500,500
04/17/25,Food,Snack,Almonds,1,8000,8000,0,7000,1000
04/17/25,Food,Beverages,Lemon Tea,5,4000,20000,0,15000,5000
04/17/25,Food,Beverages,Ocha,2,4000,8000,0,7000,1000
04/17/25,Food,Beverages,Lychee Tea,3,6000,18000,0,15000,3000
04/17/25,Food,Beverages,Oolong Tea,1,6000,6000,0,5000,1000
04/17/25,Food,Beverages,Soda,3,5000,15000,0,12000,3000
04/18/25,Food,Food,Takoyaki,3,10000,30000,0,24000,6000
04/18/25,Food,Food,Steak,4,60000,240000,0,220000,20000
04/18/25,Food,Food,Rendang,1,10000,10000,0,8000,2000
04/18/25,Food,Food,Fried Chicken,10,3000,30000,0,20000,10000
04/18/25,Food,Food,Noodles,8,6000,48000,0,40000,8000
04/18/25,Food,Food,Salmon,4,15000,60000,0,56000,4000
04/18/25,Food,Food,Macaroni,1,5000,5000,0,4000,1000
04/18/25,Food,Food,Fish & Chips,3,30000,90000,0,81000,9000
04/18/25,Food,Food,Burger,2,15000,30000,0,28000,2000
04/18/25,Food,Food,Hotdog,3,10000,30000,0,27000,3000
04/18/25,Food,Food,Pasta,1,18000,18000,0,16000,2000
04/18/25,Food,Snack,Chips,2,5000,10000,0,8000,2000
04/18/25,Food,Snack,Popcorn,1,7000,7000,0,6500,500
04/18/25,Food,Snack,Almonds,1,8000,8000,0,7000,1000
04/18/25,Food,Beverages,Lemon Tea,5,4000,20000,0,15000,5000
04/18/25,Food,Beverages,Ocha,2,4000,8000,0,7000,1000
04/18/25,Food,Beverages,Lychee Tea,3,6000,18000,0,15000,3000
04/18/25,Food,Beverages,Oolong Tea,1,6000,6000,0,5000,1000
04/18/25,Food,Beverages,Soda,3,5000,15000,0,12000,3000
04/19/25,Food,Food,Takoyaki,3,10000,30000,0,24000,6000
04/19/25,Food,Food,Steak,4,60000,240000,0,220000,20000
04/19/25,Food,Food,Rendang,1,10000,10000,0,8000,2000
04/19/25,Food,Food,Fried Chicken,10,3000,30000,0,20000,10000
04/19/25,Food,Food,Noodles,8,6000,48000,0,40000,8000
04/19/25,Food,Food,Salmon,4,15000,60000,0,56000,4000
04/19/25,Food,Food,Macaroni,1,5000,5000,0,4000,1000
04/19/25,Food,Food,Fish & Chips,3,30000,90000,0,81000,9000
04/19/25,Food,Food,Burger,2,15000,30000,0,28000,2000
04/19/25,Food,Food,Hotdog,3,10000,30000,0,27000,3000
04/19/25,Food,Food,Pasta,1,18000,18000,0,16000,2000
04/19/25,Food,Snack,Chips,2,5000,10000,0,8000,2000
04/19/25,Food,Snack,Popcorn,1,7000,7000,0,6500,500
04/19/25,Food,Snack,Almonds,1,8000,8000,0,7000,1000
04/19/25,Food,Beverages,Lemon Tea,5,4000,20000,0,15000,5000
04/19/25,Food,Beverages,Ocha,2,4000,8000,0,7000,1000
04/19/25,Food,Beverages,Lychee Tea,3,6000,18000,0,15000,3000
04/19/25,Food,Beverages,Oolong Tea,1,6000,6000,0,5000,1000
04/19/25,Food,Beverages,Soda,3,5000,15000,0,12000,3000
04/20/25,Food,Food,Takoyaki,3,10000,30000,0,24000,6000
04/20/25,Food,Food,Steak,4,60000,240000,0,220000,20000
04/20/25,Food,Food,Rendang,1,10000,10000,0,8000,2000
04/20/25,Food,Food,Fried Chicken,10,3000,30000,0,20000,10000
04/20/25,Food,Food,Noodles,8,6000,48000,0,40000,8000
04/20/25,Food,Food,Salmon,4,15000,60000,0,56000,4000
04/20/25,Food,Food,Macaroni,1,5000,5000,0,4000,1000
04/20/25,Food,Food,Fish & Chips,3,30000,90000,0,81000,9000
04/20/25,Food,Food,Burger,2,15000,30000,0,28000,2000
04/20/25,Food,Food,Hotdog,3,10000,30000,0,27000,3000
04/20/25,Food,Food,Pasta,1,18000,18000,0,16000,2000
04/20/25,Food,Snack,Chips,2,5000,10000,0,8000,2000
04/20/25,Food,Snack,Popcorn,1,7000,7000,0,6500,500
04/20/25,Food,Snack,Almonds,1,8000,8000,0,7000,1000
04/20/25,Food,Beverages,Lemon Tea,5,4000,20000,0,15000,5000
04/20/25,Food,Beverages,Ocha,2,4000,8000,0,7000,1000
04/20/25,Food,Beverages,Lychee Tea,3,6000,18000,0,15000,3000
04/20/25,Food,Beverages,Oolong Tea,1,6000,6000,0,5000,1000
04/20/25,Food,Beverages,Soda,3,5000,15000,0,12000,3000
04/21/25,Food,Food,Takoyaki,3,10000,30000,0,24000,6000
04/21/25,Food,Food,Steak,4,60000,240000,0,220000,20000
04/21/25,Food,Food,Rendang,1,10000,10000,0,8000,2000
04/21/25,Food,Food,Fried Chicken,10,3000,30000,0,20000,10000
04/21/25,Food,Food,Noodles,8,6000,48000,0,40000,8000
04/21/25,Food,Food,Salmon,4,15000,60000,0,56000,4000
04/21/25,Food,Food,Macaroni,1,5000,5000,0,4000,1000
04/21/25,Food,Food,Fish & Chips,3,30000,90000,0,81000,9000
04/21/25,Food,Food,Burger,2,15000,30000,0,28000,2000
04/21/25,Food,Food,Hotdog,3,10000,30000,0,27000,3000
04/21/25,Food,Food,Pasta,1,18000,18000,0,16000,2000
04/21/25,Food,Snack,Chips,2,5000,10000,0,8000,2000
04/21/25,Food,Snack,Popcorn,1,7000,7000,0,6500,500
04/21/25,Food,Snack,Almonds,1,8000,8000,0,7000,1000
04/21/25,Food,Beverages,Lemon Tea,5,4000,20000,0,15000,5000
04/21/25,Food,Beverages,Ocha,2,4000,8000,0,7000,1000
04/21/25,Food,Beverages,Lychee Tea,3,6000,18000,0,15000,3000
04/21/25,Food,Beverages,Oolong Tea,1,6000,6000,0,5000,1000
04/21/25,Food,Beverages,Soda,3,5000,15000,0,12000,3000
04/22/25,Food,Food,Takoyaki,3,10000,30000,0,24000,6000
04/22/25,Food,Food,Steak,4,60000,240000,0,220000,20000
04/22/25,Food,Food,Rendang,1,10000,10000,0,8000,2000
04/22/25,Food,Food,Fried Chicken,10,3000,30000,0,20000,10000
04/22/25,Food,Food,Noodles,8,6000,48000,0,40000,8000
04/22/25,Food,Food,Salmon,4,15000,60000,0,56000,4000
04/22/25,Food,Food,Macaroni,1,5000,5000,0,4000,1000
04/22/25,Food,Food,Fish & Chips,3,30000,90000,0,81000,9000
04/22/25,Food,Food,Burger,2,15000,30000,0,28000,2000
04/22/25,Food,Food,Hotdog,3,10000,30000,0,27000,3000
04/22/25,Food,Food,Pasta,1,18000,18000,0,16000,2000
04/22/25,Food,Snack,Chips,2,5000,10000,0,8000,2000
04/22/25,Food,Snack,Popcorn,1,7000,7000,0,6500,500
04/22/25,Food,Snack,Almonds,1,8000,8000,0,7000,1000
04/22/25,Food,Beverages,Lemon Tea,5,4000,20000,0,15000,5000
04/22/25,Food,Beverages,Ocha,2,4000,8000,0,7000,1000
04/22/25,Food,Beverages,Lychee Tea,3,6000,18000,0,15000,3000
04/22/25,Food,Beverages,Oolong Tea,1,6000,6000,0,5000,1000
04/22/25,Food,Beverages,Soda,3,5000,15000,0,12000,3000
04/23/25,Food,Food,Takoyaki,3,10000,30000,0,24000,6000
04/23/25,Food,Food,Steak,4,60000,240000,0,220000,20000
04/23/25,Food,Food,Rendang,1,10000,10000,0,8000,2000
04/23/25,Food,Food,Fried Chicken,10,3000,30000,0,20000,10000
04/23/25,Food,Food,Noodles,8,6000,48000,0,40000,8000
04/23/25,Food,Food,Salmon,4,15000,60000,0,56000,4000
04/23/25,Food,Food,Macaroni,1,5000,5000,0,4000,1000
04/23/25,Food,Food,Fish & Chips,3,30000,90000,0,81000,9000
04/23/25,Food,Food,Burger,2,15000,30000,0,28000,2000
04/23/25,Food,Food,Hotdog,3,10000,30000,0,27000,3000
04/23/25,Food,Food,Pasta,1,18000,18000,0,16000,2000
04/23/25,Food,Snack,Chips,2,5000,10000,0,8000,2000
04/23/25,Food,Snack,Popcorn,1,7000,7000,0,6500,500
04/23/25,Food,Snack,Almonds,1,8000,8000,0,7000,1000
04/23/25,Food,Beverages,Lemon Tea,5,4000,20000,0,15000,5000
04/23/25,Food,Beverages,Ocha,2,4000,8000,0,7000,1000
04/23/25,Food,Beverages,Lychee Tea,3,6000,18000,0,15000,3000
04/23/25,Food,Beverages,Oolong Tea,1,6000,6000,0,5000,1000
04/23/25,Food,Beverages,Soda,3,5000,15000,0,12000,3000
04/24/25,Food,Food,Takoyaki,3,10000,30000,0,24000,6000
04/24/25,Food,Food,Steak,4,60000,240000,0,220000,20000
04/24/25,Food,Food,Rendang,1,10000,10000,0,8000,2000
04/24/25,Food,Food,Fried Chicken,10,3000,30000,0,20000,10000
04/24/25,Food,Food,Noodles,8,6000,48000,0,40000,8000
04/24/25,Food,Food,Salmon,4,15000,60000,0,56000,4000
04/24/25,Food,Food,Macaroni,1,5000,5000,0,4000,1000
04/24/25,Food,Food,Fish & Chips,3,30000,90000,0,81000,9000
04/24/25,Food,Food,Burger,2,15000,30000,0,28000,2000
04/24/25,Food,Food,Hotdog,3,10000,30000,0,27000,3000
04/24/25,Food,Food,Pasta,1,18000,18000,0,16000,2000
04/24/25,Food,Snack,Chips,2,5000,10000,0,8000,2000
04/24/25,Food,Snack,Popcorn,1,7000,7000,0,6500,500
04/24/25,Food,Snack,Almonds,1,8000,8000,0,7000,1000
04/24/25,Food,Beverages,Lemon Tea,5,4000,20000,0,15000,5000
04/24/25,Food,Beverages,Ocha,2,4000,8000,0,7000,1000
04/24/25,Food,Beverages,Lychee Tea,3,6000,18000,0,15000,3000
04/24/25,Food,Beverages,Oolong Tea,1,6000,6000,0,5000,1000
04/24/25,Food,Beverages,Soda,3,5000,15000,0,12000,3000
04/25/25,Food,Food,Takoyaki,3,10000,30000,0,24000,6000
04/25/25,Food,Food,Steak,4,60000,240000,0,220000,20000
04/25/25,Food,Food,Rendang,1,10000,10000,0,8000,2000
04/25/25,Food,Food,Fried Chicken,10,3000,30000,0,20000,10000
04/25/25,Food,Food,Noodles,8,6000,48000,0,40000,8000
04/25/25,Food,Food,Salmon,4,15000,60000,0,56000,4000
04/25/25,Food,Food,Macaroni,1,5000,5000,0,4000,1000
04/25/25,Food,Food,Fish & Chips,3,30000,90000,0,81000,9000
04/25/25,Food,Food,Burger,2,15000,30000,0,28000,2000
04/25/25,Food,Food,Hotdog,3,10000,30000,0,27000,3000
04/25/25,Food,Food,Pasta,1,18000,18000,0,16000,2000
04/25/25,Food,Snack,Chips,2,5000,10000,0,8000,2000
04/25/25,Food,Snack,Popcorn,1,7000,7000,0,6500,500
04/25/25,Food,Snack,Almonds,1,8000,8000,0,7000,1000
04/25/25,Food,Beverages,Lemon Tea,5,4000,20000,0,15000,5000
04/25/25,Food,Beverages,Ocha,2,4000,8000,0,7000,1000
04/25/25,Food,Beverages,Lychee Tea,3,6000,18000,0,15000,3000
04/25/25,Food,Beverages,Oolong Tea,1,6000,6000,0,5000,1000
04/25/25,Food,Beverages,Soda,3,5000,15000,0,12000,3000
04/26/25,Food,Food,Takoyaki,3,10000,30000,0,24000,6000
04/26/25,Food,Food,Steak,4,60000,240000,0,220000,20000
04/26/25,Food,Food,Rendang,1,10000,10000,0,8000,2000
04/26/25,Food,Food,Fried Chicken,10,3000,30000,0,20000,10000
04/26/25,Food,Food,Noodles,8,6000,48000,0,40000,8000
04/26/25,Food,Food,Salmon,4,15000,60000,0,56000,4000
04/26/25,Food,Food,Macaroni,1,5000,5000,0,4000,1000
04/26/25,Food,Food,Fish & Chips,3,30000,90000,0,81000,9000
04/26/25,Food,Food,Burger,2,15000,30000,0,28000,2000
04/26/25,Food,Food,Hotdog,3,10000,30000,0,27000,3000
04/26/25,Food,Food,Pasta,1,18000,18000,0,16000,2000
04/26/25,Food,Snack,Chips,2,5000,10000,0,8000,2000
04/26/25,Food,Snack,Popcorn,1,7000,7000,0,6500,500
04/26/25,Food,Snack,Almonds,1,8000,8000,0,7000,1000
04/26/25,Food,Beverages,Lemon Tea,5,4000,20000,0,15000,5000
04/26/25,Food,Beverages,Ocha,2,4000,8000,0,7000,1000
04/26/25,Food,Beverages,Lychee Tea,3,6000,18000,0,15000,3000
04/26/25,Food,Beverages,Oolong Tea,1,6000,6000,0,5000,1000
04/26/25,Food,Beverages,Soda,3,5000,15000,0,12000,3000
04/27/25,Food,Food,Takoyaki,3,10000,30000,0,24000,6000
04/27/25,Food,Food,Steak,4,60000,240000,0,220000,20000
04/27/25,Food,Food,Rendang,1,10000,10000,0,8000,2000
04/27/25,Food,Food,Fried Chicken,10,3000,30000,0,20000,10000
04/27/25,Food,Food,Noodles,8,6000,48000,0,40000,8000
04/27/25,Food,Food,Salmon,4,15000,60000,0,56000,4000
04/27/25,Food,Food,Macaroni,1,5000,5000,0,4000,1000
04/27/25,Food,Food,Fish & Chips,3,30000,90000,0,81000,9000
04/27/25,Food,Food,Burger,2,15000,30000,0,28000,2000
04/27/25,Food,Food,Hotdog,3,10000,30000,0,27000,3000
04/27/25,Food,Food,Pasta,1,18000,18000,0,16000,2000
04/27/25,Food,Snack,Chips,2,5000,10000,0,8000,2000
04/27/25,Food,Snack,Popcorn,1,7000,7000,0,6500,500
04/27/25,Food,Snack,Almonds,1,8000,8000,0,7000,1000
04/27/25,Food,Beverages,Lemon Tea,5,4000,20000,0,15000,5000
04/27/25,Food,Beverages,Ocha,2,4000,8000,0,7000,1000
04/27/25,Food,Beverages,Lychee Tea,3,6000,18000,0,15000,3000
04/27/25,Food,Beverages,Oolong Tea,1,6000,6000,0,5000,1000
04/27/25,Food,Beverages,Soda,3,5000,15000,0,12000,3000
04/28/25,Food,Food,Takoyaki,3,10000,30000,0,24000,6000
04/28/25,Food,Food,Steak,4,60000,240000,0,220000,20000
04/28/25,Food,Food,Rendang,1,10000,10000,0,8000,2000
04/28/25,Food,Food,Fried Chicken,10,3000,30000,0,20000,10000
04/28/25,Food,Food,Noodles,8,6000,48000,0,40000,8000
04/28/25,Food,Food,Salmon,4,15000,60000,0,56000,4000
04/28/25,Food,Food,Macaroni,1,5000,5000,0,4000,1000
04/28/25,Food,Food,Fish & Chips,3,30000,90000,0,81000,9000
04/28/25,Food,Food,Burger,2,15000,30000,0,28000,2000
04/28/25,Food,Food,Hotdog,3,10000,30000,0,27000,3000
04/28/25,Food,Food,Pasta,1,18000,18000,0,16000,2000
04/28/25,Food,Snack,Chips,2,5000,10000,0,8000,2000
04/28/25,Food,Snack,Popcorn,1,7000,7000,0,6500,500
04/28/25,Food,Snack,Almonds,1,8000,8000,0,7000,1000
04/28/25,Food,Beverages,Lemon Tea,5,4000,20000,0,15000,5000
04/28/25,Food,Beverages,Ocha,2,4000,8000,0,7000,1000
04/28/25,Food,Beverages,Lychee Tea,3,6000,18000,0,15000,3000
04/28/25,Food,Beverages,Oolong Tea,1,6000,6000,0,5000,1000
04/28/25,Food,Beverages,Soda,3,5000,15000,0,12000,3000
04/29/25,Food,Food,Takoyaki,3,10000,30000,0,24000,6000
04/29/25,Food,Food,Steak,4,60000,240000,0,220000,20000
04/29/25,Food,Food,Rendang,1,10000,10000,0,8000,2000
04/29/25,Food,Food,Fried Chicken,10,3000,30000,0,20000,10000
04/29/25,Food,Food,Noodles,8,6000,48000,0,40000,8000
04/29/25,Food,Food,Salmon,4,15000,60000,0,56000,4000
04/29/25,Food,Food,Macaroni,1,5000,5000,0,4000,1000
04/29/25,Food,Food,Fish & Chips,3,30000,90000,0,81000,9000
04/29/25,Food,Food,Burger,2,15000,30000,0,28000,2000
04/29/25,Food,Food,Hotdog,3,10000,30000,0,27000,3000
04/29/25,Food,Food,Pasta,1,18000,18000,0,16000,2000
04/29/25,Food,Snack,Chips,2,5000,10000,0,8000,2000
04/29/25,Food,Snack,Popcorn,1,7000,7000,0,6500,500
04/29/25,Food,Snack,Almonds,1,8000,8000,0,7000,1000
04/29/25,Food,Beverages,Lemon Tea,5,4000,20000,0,15000,5000
04/29/25,Food,Beverages,Ocha,2,4000,8000,0,7000,1000
04/29/25,Food,Beverages,Lychee Tea,3,6000,18000,0,15000,3000
04/29/25,Food,Beverages,Oolong Tea,1,6000,6000,0,5000,1000
04/29/25,Food,Beverages,Soda,3,5000,15000,0,12000,3000
04/30/25,Food,Food,Takoyaki,3,10000,30000,0,24000,6000
04/30/25,Food,Food,Steak,4,60000,240000,0,220000,20000
04/30/25,Food,Food,Rendang,1,10000,10000,0,8000,2000
04/30/25,Food,Food,Fried Chicken,10,3000,30000,0,20000,10000
04/30/25,Food,Food,Noodles,8,6000,48000,0,40000,8000
04/30/25,Food,Food,Salmon,4,15000,60000,0,56000,4000
04/30/25,Food,Food,Macaroni,1,5000,5000,0,4000,1000
04/30/25,Food,Food,Fish & Chips,3,30000,90000,0,81000,9000
04/30/25,Food,Food,Burger,2,15000,30000,0,28000,2000
04/30/25,Food,Food,Hotdog,3,10000,30000,0,27000,3000
04/30/25,Food,Food,Pasta,1,18000,18000,0,16000,2000
04/30/25,Food,Snack,Chips,2,5000,10000,0,8000,2000
04/30/25,Food,Snack,Popcorn,1,7000,7000,0,6500,500
04/30/25,Food,Snack,Almonds,1,8000,8000,0,7000,1000
04/30/25,Food,Beverages,Lemon Tea,5,4000,20000,0,15000,5000
04/30/25,Food,Beverages,Ocha,2,4000,8000,0,7000,1000
04/30/25,Food,Beverages,Lychee Tea,3,6000,18000,0,15000,3000
04/30/25,Food,Beverages,Oolong Tea,1,6000,6000,0,5000,1000
04/30/25,Food,Beverages,Soda,3,5000,15000,0,12000,3000
05/01/25,Food,Food,Takoyaki,3,10000,30000,0,24000,6000
05/01/25,Food,Food,Steak,4,60000,240000,0,220000,20000
05/01/25,Food,Food,Rendang,1,10000,10000,0,8000,2000
05/01/25,Food,Food,Fried Chicken,10,3000,30000,0,20000,10000
05/01/25,Food,Food,Noodles,8,6000,48000,0,40000,8000
05/01/25,Food,Food,Salmon,4,15000,60000,0,56000,4000
05/01/25,Food,Food,Macaroni,1,5000,5000,0,4000,1000
05/01/25,Food,Food,Fish & Chips,3,30000,90000,0,81000,9000
05/01/25,Food,Food,Burger,2,15000,30000,0,28000,2000
05/01/25,Food,Food,Hotdog,3,10000,30000,0,27000,3000
05/01/25,Food,Food,Pasta,1,18000,18000,0,16000,2000
05/01/25,Food,Snack,Chips,2,5000,10000,0,8000,2000
05/01/25,Food,Snack,Popcorn,1,7000,7000,0,6500,500
05/01/25,Food,Snack,Almonds,1,8000,8000,0,7000,1000
05/01/25,Food,Beverages,Lemon Tea,5,4000,20000,0,15000,5000
05/01/25,Food,Beverages,Ocha,2,4000,8000,0,7000,1000
05/01/25,Food,Beverages,Lychee Tea,3,6000,18000,0,15000,3000
05/01/25,Food,Beverages,Oolong Tea,1,6000,6000,0,5000,1000
05/01/25,Food,Beverages,Soda,3,5000,15000,0,12000,3000
05/02/25,Food,Food,Takoyaki,3,10000,30000,0,24000,6000
05/02/25,Food,Food,Steak,4,60000,240000,0,220000,20000
05/02/25,Food,Food,Rendang,1,10000,10000,0,8000,2000
05/02/25,Food,Food,Fried Chicken,10,3000,30000,0,20000,10000
05/02/25,Food,Food,Noodles,8,6000,48000,0,40000,8000
05/02/25,Food,Food,Salmon,4,15000,60000,0,56000,4000
05/02/25,Food,Food,Macaroni,1,5000,5000,0,4000,1000
05/02/25,Food,Food,Fish & Chips,3,30000,90000,0,81000,9000
05/02/25,Food,Food,Burger,2,15000,30000,0,28000,2000
05/02/25,Food,Food,Hotdog,3,10000,30000,0,27000,3000
05/02/25,Food,Food,Pasta,1,18000,18000,0,16000,2000
05/02/25,Food,Snack,Chips,2,5000,10000,0,8000,2000
05/02/25,Food,Snack,Popcorn,1,7000,7000,0,6500,500
05/02/25,Food,Snack,Almonds,1,8000,8000,0,7000,1000
05/02/25,Food,Beverages,Lemon Tea,5,4000,20000,0,15000,5000
05/02/25,Food,Beverages,Ocha,2,4000,8000,0,7000,1000
05/02/25,Food,Beverages,Lychee Tea,3,6000,18000,0,15000,3000
05/02/25,Food,Beverages,Oolong Tea,1,6000,6000,0,5000,1000
05/02/25,Food,Beverages,Soda,3,5000,15000,0,12000,3000
05/03/25,Food,Food,Takoyaki,3,10000,30000,0,24000,6000
05/03/25,Food,Food,Steak,4,60000,240000,0,220000,20000
05/03/25,Food,Food,Rendang,1,10000,10000,0,8000,2000
05/03/25,Food,Food,Fried Chicken,10,3000,30000,0,20000,10000
05/03/25,Food,Food,Noodles,8,6000,48000,0,40000,8000
05/03/25,Food,Food,Salmon,4,15000,60000,0,56000,4000
05/03/25,Food,Food,Macaroni,1,5000,5000,0,4000,1000
05/03/25,Food,Food,Fish & Chips,3,30000,90000,0,81000,9000
05/03/25,Food,Food,Burger,2,15000,30000,0,28000,2000
05/03/25,Food,Food,Hotdog,3,10000,30000,0,27000,3000
05/03/25,Food,Food,Pasta,1,18000,18000,0,16000,2000
05/03/25,Food,Snack,Chips,2,5000,10000,0,8000,2000
05/03/25,Food,Snack,Popcorn,1,7000,7000,0,6500,500
05/03/25,Food,Snack,Almonds,1,8000,8000,0,7000,1000
05/03/25,Food,Beverages,Lemon Tea,5,4000,20000,0,15000,5000
05/03/25,Food,Beverages,Ocha,2,4000,8000,0,7000,1000
05/03/25,Food,Beverages,Lychee Tea,3,6000,18000,0,15000,3000
05/03/25,Food,Beverages,Oolong Tea,1,6000,6000,0,5000,1000
05/03/25,Food,Beverages,Soda,3,5000,15000,0,12000,3000
05/04/25,Food,Food,Takoyaki,3,10000,30000,0,24000,6000
05/04/25,Food,Food,Steak,4,60000,240000,0,220000,20000
05/04/25,Food,Food,Rendang,1,10000,10000,0,8000,2000
05/04/25,Food,Food,Fried Chicken,10,3000,30000,0,20000,10000
05/04/25,Food,Food,Noodles,8,6000,48000,0,40000,8000
05/04/25,Food,Food,Salmon,4,15000,60000,0,56000,4000
05/04/25,Food,Food,Macaroni,1,5000,5000,0,4000,1000
05/04/25,Food,Food,Fish & Chips,3,30000,90000,0,81000,9000
05/04/25,Food,Food,Burger,2,15000,30000,0,28000,2000
05/04/25,Food,Food,Hotdog,3,10000,30000,0,27000,3000
05/04/25,Food,Food,Pasta,1,18000,18000,0,16000,2000
05/04/25,Food,Snack,Chips,2,5000,10000,0,8000,2000
05/04/25,Food,Snack,Popcorn,1,7000,7000,0,6500,500
05/04/25,Food,Snack,Almonds,1,8000,8000,0,7000,1000
05/04/25,Food,Beverages,Lemon Tea,5,4000,20000,0,15000,5000
05/04/25,Food,Beverages,Ocha,2,4000,8000,0,7000,1000
05/04/25,Food,Beverages,Lychee Tea,3,6000,18000,0,15000,3000
05/04/25,Food,Beverages,Oolong Tea,1,6000,6000,0,5000,1000
05/04/25,Food,Beverages,Soda,3,5000,15000,0,12000,3000
05/05/25,Food,Food,Takoyaki,3,10000,30000,0,24000,6000
05/05/25,Food,Food,Steak,4,60000,240000,0,220000,20000
05/05/25,Food,Food,Rendang,1,10000,10000,0,8000,2000
05/05/25,Food,Food,Fried Chicken,10,3000,30000,0,20000,10000
05/05/25,Food,Food,Noodles,8,6000,48000,0,40000,8000
05/05/25,Food,Food,Salmon,4,15000,60000,0,56000,4000
05/05/25,Food,Food,Macaroni,1,5000,5000,0,4000,1000
05/05/25,Food,Food,Fish & Chips,3,30000,90000,0,81000,9000
05/05/25,Food,Food,Burger,2,15000,30000,0,28000,2000
05/05/25,Food,Food,Hotdog,3,10000,30000,0,27000,3000
05/05/25,Food,Food,Pasta,1,18000,18000,0,16000,2000
05/05/25,Food,Snack,Chips,2,5000,10000,0,8000,2000
05/05/25,Food,Snack,Popcorn,1,7000,7000,0,6500,500
05/05/25,Food,Snack,Almonds,1,8000,8000,0,7000,1000
05/05/25,Food,Beverages,Lemon Tea,5,4000,20000,0,15000,5000
05/05/25,Food,Beverages,Ocha,2,4000,8000,0,7000,1000
05/05/25,Food,Beverages,Lychee Tea,3,6000,18000,0,15000,3000
05/05/25,Food,Beverages,Oolong Tea,1,6000,6000,0,5000,1000
05/05/25,Food,Beverages,Soda,3,5000,15000,0,12000,3000
05/06/25,Food,Food,Takoyaki,3,10000,30000,0,24000,6000
05/06/25,Food,Food,Steak,4,60000,240000,0,220000,20000
05/06/25,Food,Food,Rendang,1,10000,10000,0,8000,2000
05/06/25,Food,Food,Fried Chicken,10,3000,30000,0,20000,10000
05/06/25,Food,Food,Noodles,8,6000,48000,0,40000,8000
05/06/25,Food,Food,Salmon,4,15000,60000,0,56000,4000
05/06/25,Food,Food,Macaroni,1,5000,5000,0,4000,1000
05/06/25,Food,Food,Fish & Chips,3,30000,90000,0,81000,9000
05/06/25,Food,Food,Burger,2,15000,30000,0,28000,2000
05/06/25,Food,Food,Hotdog,3,10000,30000,0,27000,3000
05/06/25,Food,Food,Pasta,1,18000,18000,0,16000,2000
05/06/25,Food,Snack,Chips,2,5000,10000,0,8000,2000
05/06/25,Food,Snack,Popcorn,1,7000,7000,0,6500,500
05/06/25,Food,Snack,Almonds,1,8000,8000,0,7000,1000
05/06/25,Food,Beverages,Lemon Tea,5,4000,20000,0,15000,5000
05/06/25,Food,Beverages,Ocha,2,4000,8000,0,7000,1000
05/06/25,Food,Beverages,Lychee Tea,3,6000,18000,0,15000,3000
05/06/25,Food,Beverages,Oolong Tea,1,6000,6000,0,5000,1000
05/06/25,Food,Beverages,Soda,3,5000,15000,0,12000,3000
05/07/25,Food,Food,Takoyaki,3,10000,30000,0,24000,6000
05/07/25,Food,Food,Steak,4,60000,240000,0,220000,20000
05/07/25,Food,Food,Rendang,1,10000,10000,0,8000,2000
05/07/25,Food,Food,Fried Chicken,10,3000,30000,0,20000,10000
05/07/25,Food,Food,Noodles,8,6000,48000,0,40000,8000
05/07/25,Food,Food,Salmon,4,15000,60000,0,56000,4000
05/07/25,Food,Food,Macaroni,1,5000,5000,0,4000,1000
05/07/25,Food,Food,Fish & Chips,3,30000,90000,0,81000,9000
05/07/25,Food,Food,Burger,2,15000,30000,0,28000,2000
05/07/25,Food,Food,Hotdog,3,10000,30000,0,27000,3000
05/07/25,Food,Food,Pasta,1,18000,18000,0,16000,2000
05/07/25,Food,Snack,Chips,2,5000,10000,0,8000,2000
05/07/25,Food,Snack,Popcorn,1,7000,7000,0,6500,500
05/07/25,Food,Snack,Almonds,1,8000,8000,0,7000,1000
05/07/25,Food,Beverages,Lemon Tea,5,4000,20000,0,15000,5000
05/07/25,Food,Beverages,Ocha,2,4000,8000,0,7000,1000
05/07/25,Food,Beverages,Lychee Tea,3,6000,18000,0,15000,3000
05/07/25,Food,Beverages,Oolong Tea,1,6000,6000,0,5000,1000
05/07/25,Food,Beverages,Soda,3,5000,15000,0,12000,3000
05/08/25,Food,Food,Takoyaki,3,10000,30000,0,24000,6000
05/08/25,Food,Food,Steak,4,60000,240000,0,220000,20000
05/08/25,Food,Food,Rendang,1,10000,10000,0,8000,2000
05/08/25,Food,Food,Fried Chicken,10,3000,30000,0,20000,10000
05/08/25,Food,Food,Noodles,8,6000,48000,0,40000,8000
05/08/25,Food,Food,Salmon,4,15000,60000,0,56000,4000
05/08/25,Food,Food,Macaroni,1,5000,5000,0,4000,1000
05/08/25,Food,Food,Fish & Chips,3,30000,90000,0,81000,9000
05/08/25,Food,Food,Burger,2,15000,30000,0,28000,2000
05/08/25,Food,Food,Hotdog,3,10000,30000,0,27000,3000
05/08/25,Food,Food,Pasta,1,18000,18000,0,16000,2000
05/08/25,Food,Snack,Chips,2,5000,10000,0,8000,2000
05/08/25,Food,Snack,Popcorn,1,7000,7000,0,6500,500
05/08/25,Food,Snack,Almonds,1,8000,8000,0,7000,1000
05/08/25,Food,Beverages,Lemon Tea,5,4000,20000,0,15000,5000
05/08/25,Food,Beverages,Ocha,2,4000,8000,0,7000,1000
05/08/25,Food,Beverages,Lychee Tea,3,6000,18000,0,15000,3000
05/08/25,Food,Beverages,Oolong Tea,1,6000,6000,0,5000,1000
05/08/25,Food,Beverages,Soda,3,5000,15000,0,12000,3000
05/09/25,Food,Food,Takoyaki,3,10000,30000,0,24000,6000
05/09/25,Food,Food,Steak,4,60000,240000,0,220000,20000
05/09/25,Food,Food,Rendang,1,10000,10000,0,8000,2000
05/09/25,Food,Food,Fried Chicken,10,3000,30000,0,20000,10000
05/09/25,Food,Food,Noodles,8,6000,48000,0,40000,8000
05/09/25,Food,Food,Salmon,4,15000,60000,0,56000,4000
05/09/25,Food,Food,Macaroni,1,5000,5000,0,4000,1000
05/09/25,Food,Food,Fish & Chips,3,30000,90000,0,81000,9000
05/09/25,Food,Food,Burger,2,15000,30000,0,28000,2000
05/09/25,Food,Food,Hotdog,3,10000,30000,0,27000,3000
05/09/25,Food,Food,Pasta,1,18000,18000,0,16000,2000
05/09/25,Food,Snack,Chips,2,5000,10000,0,8000,2000
05/09/25,Food,Snack,Popcorn,1,7000,7000,0,6500,500
05/09/25,Food,Snack,Almonds,1,8000,8000,0,7000,1000
05/09/25,Food,Beverages,Lemon Tea,5,4000,20000,0,15000,5000
05/09/25,Food,Beverages,Ocha,2,4000,8000,0,7000,1000
05/09/25,Food,Beverages,Lychee Tea,3,6000,18000,0,15000,3000
05/09/25,Food,Beverages,Oolong Tea,1,6000,6000,0,5000,1000
05/09/25,Food,Beverages,Soda,3,5000,15000,0,12000,3000
05/10/25,Food,Food,Takoyaki,3,10000,30000,0,24000,6000
05/10/25,Food,Food,Steak,4,60000,240000,0,220000,20000
05/10/25,Food,Food,Rendang,1,10000,10000,0,8000,2000
05/10/25,Food,Food,Fried Chicken,10,3000,30000,0,20000,10000
05/10/25,Food,Food,Noodles,8,6000,48000,0,40000,8000
05/10/25,Food,Food,Salmon,4,15000,60000,0,56000,4000
05/10/25,Food,Food,Macaroni,1,5000,5000,0,4000,1000
05/10/25,Food,Food,Fish & Chips,3,30000,90000,0,81000,9000
05/10/25,Food,Food,Burger,2,15000,30000,0,28000,2000
05/10/25,Food,Food,Hotdog,3,10000,30000,0,27000,3000
05/10/25,Food,Food,Pasta,1,18000,18000,0,16000,2000
05/10/25,Food,Snack,Chips,2,5000,10000,0,8000,2000
05/10/25,Food,Snack,Popcorn,1,7000,7000,0,6500,500
05/10/25,Food,Snack,Almonds,1,8000,8000,0,7000,1000
05/10/25,Food,Beverages,Lemon Tea,5,4000,20000,0,15000,5000
05/10/25,Food,Beverages,Ocha,2,4000,8000,0,7000,1000
05/10/25,Food,Beverages,Lychee Tea,3,6000,18000,0,15000,3000
05/10/25,Food,Beverages,Oolong Tea,1,6000,6000,0,5000,1000
05/10/25,Food,Beverages,Soda,3,5000,15000,0,12000,3000
05/11/25,Food,Food,Takoyaki,3,10000,30000,0,24000,6000
05/11/25,Food,Food,Steak,4,60000,240000,0,220000,20000
05/11/25,Food,Food,Rendang,1,10000,10000,0,8000,2000
05/11/25,Food,Food,Fried Chicken,10,3000,30000,0,20000,10000
05/11/25,Food,Food,Noodles,8,6000,48000,0,40000,8000
05/11/25,Food,Food,Salmon,4,15000,60000,0,56000,4000
05/11/25,Food,Food,Macaroni,1,5000,5000,0,4000,1000
05/11/25,Food,Food,Fish & Chips,3,30000,90000,0,81000,9000
05/11/25,Food,Food,Burger,2,15000,30000,0,28000,2000
05/11/25,Food,Food,Hotdog,3,10000,30000,0,27000,3000
05/11/25,Food,Food,Pasta,1,18000,18000,0,16000,2000
05/11/25,Food,Snack,Chips,2,5000,10000,0,8000,2000
05/11/25,Food,Snack,Popcorn,1,7000,7000,0,6500,500
05/11/25,Food,Snack,Almonds,1,8000,8000,0,7000,1000
05/11/25,Food,Beverages,Lemon Tea,5,4000,20000,0,15000,5000
05/11/25,Food,Beverages,Ocha,2,4000,8000,0,7000,1000
05/11/25,Food,Beverages,Lychee Tea,3,6000,18000,0,15000,3000
05/11/25,Food,Beverages,Oolong Tea,1,6000,6000,0,5000,1000
05/11/25,Food,Beverages,Soda,3,5000,15000,0,12000,3000
05/12/25,Food,Food,Takoyaki,3,10000,30000,0,24000,6000
05/12/25,Food,Food,Steak,4,60000,240000,0,220000,20000
05/12/25,Food,Food,Rendang,1,10000,10000,0,8000,2000
05/12/25,Food,Food,Fried Chicken,10,3000,30000,0,20000,10000
05/12/25,Food,Food,Noodles,8,6000,48000,0,40000,8000
05/12/25,Food,Food,Salmon,4,15000,60000,0,56000,4000
05/12/25,Food,Food,Macaroni,1,5000,5000,0,4000,1000
05/12/25,Food,Food,Fish & Chips,3,30000,90000,0,81000,9000
05/12/25,Food,Food,Burger,2,15000,30000,0,28000,2000
05/12/25,Food,Food,Hotdog,3,10000,30000,0,27000,3000
05/12/25,Food,Food,Pasta,1,18000,18000,0,16000,2000
05/12/25,Food,Snack,Chips,2,5000,10000,0,8000,2000
05/12/25,Food,Snack,Popcorn,1,7000,7000,0,6500,500
05/12/25,Food,Snack,Almonds,1,8000,8000,0,7000,1000
05/12/25,Food,Beverages,Lemon Tea,5,4000,20000,0,15000,5000
05/12/25,Food,Beverages,Ocha,2,4000,8000,0,7000,1000
05/12/25,Food,Beverages,Lychee Tea,3,6000,18000,0,15000,3000
05/12/25,Food,Beverages,Oolong Tea,1,6000,6000,0,5000,1000
05/12/25,Food,Beverages,Soda,3,5000,15000,0,12000,3000
05/13/25,Food,Food,Takoyaki,3,10000,30000,0,24000,6000
05/13/25,Food,Food,Steak,4,60000,240000,0,220000,20000
05/13/25,Food,Food,Rendang,1,10000,10000,0,8000,2000
05/13/25,Food,Food,Fried Chicken,10,3000,30000,0,20000,10000
05/13/25,Food,Food,Noodles,8,6000,48000,0,40000,8000
05/13/25,Food,Food,Salmon,4,15000,60000,0,56000,4000
05/13/25,Food,Food,Macaroni,1,5000,5000,0,4000,1000
05/13/25,Food,Food,Fish & Chips,3,30000,90000,0,81000,9000
05/13/25,Food,Food,Burger,2,15000,30000,0,28000,2000
05/13/25,Food,Food,Hotdog,3,10000,30000,0,27000,3000
05/13/25,Food,Food,Pasta,1,18000,18000,0,16000,2000
05/13/25,Food,Snack,Chips,2,5000,10000,0,8000,2000
05/13/25,Food,Snack,Popcorn,1,7000,7000,0,6500,500
05/13/25,Food,Snack,Almonds,1,8000,8000,0,7000,1000
05/13/25,Food,Beverages,Lemon Tea,5,4000,20000,0,15000,5000
05/13/25,Food,Beverages,Ocha,2,4000,8000,0,7000,1000
05/13/25,Food,Beverages,Lychee Tea,3,6000,18000,0,15000,3000
05/13/25,Food,Beverages,Oolong Tea,1,6000,6000,0,5000,1000
05/13/25,Food,Beverages,Soda,3,5000,15000,0,12000,3000
05/14/25,Food,Food,Takoyaki,3,10000,30000,0,24000,6000
05/14/25,Food,Food,Steak,4,60000,240000,0,220000,20000
05/14/25,Food,Food,Rendang,1,10000,10000,0,8000,2000
05/14/25,Food,Food,Fried Chicken,10,3000,30000,0,20000,10000
05/14/25,Food,Food,Noodles,8,6000,48000,0,40000,8000
05/14/25,Food,Food,Salmon,4,15000,60000,0,56000,4000
05/14/25,Food,Food,Macaroni,1,5000,5000,0,4000,1000
05/14/25,Food,Food,Fish & Chips,3,30000,90000,0,81000,9000
05/14/25,Food,Food,Burger,2,15000,30000,0,28000,2000
05/14/25,Food,Food,Hotdog,3,10000,30000,0,27000,3000
05/14/25,Food,Food,Pasta,1,18000,18000,0,16000,2000
05/14/25,Food,Snack,Chips,2,5000,10000,0,8000,2000
05/14/25,Food,Snack,Popcorn,1,7000,7000,0,6500,500
05/14/25,Food,Snack,Almonds,1,8000,8000,0,7000,1000
05/14/25,Food,Beverages,Lemon Tea,5,4000,20000,0,15000,5000
05/14/25,Food,Beverages,Ocha,2,4000,8000,0,7000,1000
05/14/25,Food,Beverages,Lychee Tea,3,6000,18000,0,15000,3000
05/14/25,Food,Beverages,Oolong Tea,1,6000,6000,0,5000,1000
05/14/25,Food,Beverages,Soda,3,5000,15000,0,12000,3000
05/15/25,Food,Food,Takoyaki,3,10000,30000,0,24000,6000
05/15/25,Food,Food,Steak,4,60000,240000,0,220000,20000
05/15/25,Food,Food,Rendang,1,10000,10000,0,8000,2000
05/15/25,Food,Food,Fried Chicken,10,3000,30000,0,20000,10000
05/15/25,Food,Food,Noodles,8,6000,48000,0,40000,8000
05/15/25,Food,Food,Salmon,4,15000,60000,0,56000,4000
05/15/25,Food,Food,Macaroni,1,5000,5000,0,4000,1000
05/15/25,Food,Food,Fish & Chips,3,30000,90000,0,81000,9000
05/15/25,Food,Food,Burger,2,15000,30000,0,28000,2000
05/15/25,Food,Food,Hotdog,3,10000,30000,0,27000,3000
05/15/25,Food,Food,Pasta,1,18000,18000,0,16000,2000
05/15/25,Food,Snack,Chips,2,5000,10000,0,8000,2000
05/15/25,Food,Snack,Popcorn,1,7000,7000,0,6500,500
05/15/25,Food,Snack,Almonds,1,8000,8000,0,7000,1000
05/15/25,Food,Beverages,Lemon Tea,5,4000,20000,0,15000,5000
05/15/25,Food,Beverages,Ocha,2,4000,8000,0,7000,1000
05/15/25,Food,Beverages,Lychee Tea,3,6000,18000,0,15000,3000
05/15/25,Food,Beverages,Oolong Tea,1,6000,6000,0,5000,1000
05/15/25,Food,Beverages,Soda,3,5000,15000,0,12000,3000
05/16/25,Food,Food,Takoyaki,3,10000,30000,0,24000,6000
05/16/25,Food,Food,Steak,4,60000,240000,0,220000,20000
05/16/25,Food,Food,Rendang,1,10000,10000,0,8000,2000
05/16/25,Food,Food,Fried Chicken,10,3000,30000,0,20000,10000
05/16/25,Food,Food,Noodles,8,6000,48000,0,40000,8000
05/16/25,Food,Food,Salmon,4,15000,60000,0,56000,4000
05/16/25,Food,Food,Macaroni,1,5000,5000,0,4000,1000
05/16/25,Food,Food,Fish & Chips,3,30000,90000,0,81000,9000
05/16/25,Food,Food,Burger,2,15000,30000,0,28000,2000
05/16/25,Food,Food,Hotdog,3,10000,30000,0,27000,3000
05/16/25,Food,Food,Pasta,1,18000,18000,0,16000,2000
05/16/25,Food,Snack,Chips,2,5000,10000,0,8000,2000
05/16/25,Food,Snack,Popcorn,1,7000,7000,0,6500,500
05/16/25,Food,Snack,Almonds,1,8000,8000,0,7000,1000
05/16/25,Food,Beverages,Lemon Tea,5,4000,20000,0,15000,5000
05/16/25,Food,Beverages,Ocha,2,4000,8000,0,7000,1000
05/16/25,Food,Beverages,Lychee Tea,3,6000,18000,0,15000,3000
05/16/25,Food,Beverages,Oolong Tea,1,6000,6000,0,5000,1000
05/16/25,Food,Beverages,Soda,3,5000,15000,0,12000,3000
05/17/25,Food,Food,Takoyaki,3,10000,30000,0,24000,6000
05/17/25,Food,Food,Steak,4,60000,240000,0,220000,20000
05/17/25,Food,Food,Rendang,1,10000,10000,0,8000,2000
05/17/25,Food,Food,Fried Chicken,10,3000,30000,0,20000,10000
05/17/25,Food,Food,Noodles,8,6000,48000,0,40000,8000
05/17/25,Food,Food,Salmon,4,15000,60000,0,56000,4000
05/17/25,Food,Food,Macaroni,1,5000,5000,0,4000,1000
05/17/25,Food,Food,Fish & Chips,3,30000,90000,0,81000,9000
05/17/25,Food,Food,Burger,2,15000,30000,0,28000,2000
05/17/25,Food,Food,Hotdog,3,10000,30000,0,27000,3000
05/17/25,Food,Food,Pasta,1,18000,18000,0,16000,2000
05/17/25,Food,Snack,Chips,2,5000,10000,0,8000,2000
05/17/25,Food,Snack,Popcorn,1,7000,7000,0,6500,500
05/17/25,Food,Snack,Almonds,1,8000,8000,0,7000,1000
05/17/25,Food,Beverages,Lemon Tea,5,4000,20000,0,15000,5000
05/17/25,Food,Beverages,Ocha,2,4000,8000,0,7000,1000
05/17/25,Food,Beverages,Lychee Tea,3,6000,18000,0,15000,3000
05/17/25,Food,Beverages,Oolong Tea,1,6000,6000,0,5000,1000
05/17/25,Food,Beverages,Soda,3,5000,15000,0,12000,3000
05/18/25,Food,Food,Takoyaki,3,10000,30000,0,24000,6000
05/18/25,Food,Food,Steak,4,60000,240000,0,220000,20000
05/18/25,Food,Food,Rendang,1,10000,10000,0,8000,2000
05/18/25,Food,Food,Fried Chicken,10,3000,30000,0,20000,10000
05/18/25,Food,Food,Noodles,8,6000,48000,0,40000,8000
05/18/25,Food,Food,Salmon,4,15000,60000,0,56000,4000
05/18/25,Food,Food,Macaroni,1,5000,5000,0,4000,1000
05/18/25,Food,Food,Fish & Chips,3,30000,90000,0,81000,9000
05/18/25,Food,Food,Burger,2,15000,30000,0,28000,2000
05/18/25,Food,Food,Hotdog,3,10000,30000,0,27000,3000
05/18/25,Food,Food,Pasta,1,18000,18000,0,16000,2000
05/18/25,Food,Snack,Chips,2,5000,10000,0,8000,2000
05/18/25,Food,Snack,Popcorn,1,7000,7000,0,6500,500
05/18/25,Food,Snack,Almonds,1,8000,8000,0,7000,1000
05/18/25,Food,Beverages,Lemon Tea,5,4000,20000,0,15000,5000
05/18/25,Food,Beverages,Ocha,2,4000,8000,0,7000,1000
05/18/25,Food,Beverages,Lychee Tea,3,6000,18000,0,15000,3000
05/18/25,Food,Beverages,Oolong Tea,1,6000,6000,0,5000,1000
05/18/25,Food,Beverages,Soda,3,5000,15000,0,12000,3000
05/19/25,Food,Food,Takoyaki,3,10000,30000,0,24000,6000
05/19/25,Food,Food,Steak,4,60000,240000,0,220000,20000
05/19/25,Food,Food,Rendang,1,10000,10000,0,8000,2000
05/19/25,Food,Food,Fried Chicken,10,3000,30000,0,20000,10000
05/19/25,Food,Food,Noodles,8,6000,48000,0,40000,8000
05/19/25,Food,Food,Salmon,4,15000,60000,0,56000,4000
05/19/25,Food,Food,Macaroni,1,5000,5000,0,4000,1000
05/19/25,Food,Food,Fish & Chips,3,30000,90000,0,81000,9000
05/19/25,Food,Food,Burger,2,15000,30000,0,28000,2000
05/19/25,Food,Food,Hotdog,3,10000,30000,0,27000,3000
05/19/25,Food,Food,Pasta,1,18000,18000,0,16000,2000
05/19/25,Food,Snack,Chips,2,5000,10000,0,8000,2000
05/19/25,Food,Snack,Popcorn,1,7000,7000,0,6500,500
05/19/25,Food,Snack,Almonds,1,8000,8000,0,7000,1000
05/19/25,Food,Beverages,Lemon Tea,5,4000,20000,0,15000,5000
05/19/25,Food,Beverages,Ocha,2,4000,8000,0,7000,1000
05/19/25,Food,Beverages,Lychee Tea,3,6000,18000,0,15000,3000
05/19/25,Food,Beverages,Oolong Tea,1,6000,6000,0,5000,1000
05/19/25,Food,Beverages,Soda,3,5000,15000,0,12000,3000
05/20/25,Food,Food,Takoyaki,3,10000,30000,0,24000,6000
05/20/25,Food,Food,Steak,4,60000,240000,0,220000,20000
05/20/25,Food,Food,Rendang,1,10000,10000,0,8000,2000
05/20/25,Food,Food,Fried Chicken,10,3000,30000,0,20000,10000
05/20/25,Food,Food,Noodles,8,6000,48000,0,40000,8000
05/20/25,Food,Food,Salmon,4,15000,60000,0,56000,4000
05/20/25,Food,Food,Macaroni,1,5000,5000,0,4000,1000
05/20/25,Food,Food,Fish & Chips,3,30000,90000,0,81000,9000
05/20/25,Food,Food,Burger,2,15000,30000,0,28000,2000
05/20/25,Food,Food,Hotdog,3,10000,30000,0,27000,3000
05/20/25,Food,Food,Pasta,1,18000,18000,0,16000,2000
05/20/25,Food,Snack,Chips,2,5000,10000,0,8000,2000
05/20/25,Food,Snack,Popcorn,1,7000,7000,0,6500,500
05/20/25,Food,Snack,Almonds,1,8000,8000,0,7000,1000
05/20/25,Food,Beverages,Lemon Tea,5,4000,20000,0,15000,5000
05/20/25,Food,Beverages,Ocha,2,4000,8000,0,7000,1000
05/20/25,Food,Beverages,Lychee Tea,3,6000,18000,0,15000,3000
05/20/25,Food,Beverages,Oolong Tea,1,6000,6000,0,5000,1000
05/20/25,Food,Beverages,Soda,3,5000,15000,0,12000,3000
05/21/25,Food,Food,Takoyaki,3,10000,30000,0,24000,6000
05/21/25,Food,Food,Steak,4,60000,240000,0,220000,20000
05/21/25,Food,Food,Rendang,1,10000,10000,0,8000,2000
05/21/25,Food,Food,Fried Chicken,10,3000,30000,0,20000,10000
05/21/25,Food,Food,Noodles,8,6000,48000,0,40000,8000
05/21/25,Food,Food,Salmon,4,15000,60000,0,56000,4000
05/21/25,Food,Food,Macaroni,1,5000,5000,0,4000,1000
05/21/25,Food,Food,Fish & Chips,3,30000,90000,0,81000,9000
05/21/25,Food,Food,Burger,2,15000,30000,0,28000,2000
05/21/25,Food,Food,Hotdog,3,10000,30000,0,27000,3000
05/21/25,Food,Food,Pasta,1,18000,18000,0,16000,2000
05/21/25,Food,Snack,Chips,2,5000,10000,0,8000,2000
05/21/25,Food,Snack,Popcorn,1,7000,7000,0,6500,500
05/21/25,Food,Snack,Almonds,1,8000,8000,0,7000,1000
05/21/25,Food,Beverages,Lemon Tea,5,4000,20000,0,15000,5000
05/21/25,Food,Beverages,Ocha,2,4000,8000,0,7000,1000
05/21/25,Food,Beverages,Lychee Tea,3,6000,18000,0,15000,3000
05/21/25,Food,Beverages,Oolong Tea,1,6000,6000,0,5000,1000
05/21/25,Food,Beverages,Soda,3,5000,15000,0,12000,3000
05/22/25,Food,Food,Takoyaki,3,10000,30000,0,24000,6000
05/22/25,Food,Food,Steak,4,60000,240000,0,220000,20000
05/22/25,Food,Food,Rendang,1,10000,10000,0,8000,2000
05/22/25,Food,Food,Fried Chicken,10,3000,30000,0,20000,10000
05/22/25,Food,Food,Noodles,8,6000,48000,0,40000,8000
05/22/25,Food,Food,Salmon,4,15000,60000,0,56000,4000
05/22/25,Food,Food,Macaroni,1,5000,5000,0,4000,1000
05/22/25,Food,Food,Fish & Chips,3,30000,90000,0,81000,9000
05/22/25,Food,Food,Burger,2,15000,30000,0,28000,2000
05/22/25,Food,Food,Hotdog,3,10000,30000,0,27000,3000
05/22/25,Food,Food,Pasta,1,18000,18000,0,16000,2000
05/22/25,Food,Snack,Chips,2,5000,10000,0,8000,2000
05/22/25,Food,Snack,Popcorn,1,7000,7000,0,6500,500
05/22/25,Food,Snack,Almonds,1,8000,8000,0,7000,1000
05/22/25,Food,Beverages,Lemon Tea,5,4000,20000,0,15000,5000
05/22/25,Food,Beverages,Ocha,2,4000,8000,0,7000,1000
05/22/25,Food,Beverages,Lychee Tea,3,6000,18000,0,15000,3000
05/22/25,Food,Beverages,Oolong Tea,1,6000,6000,0,5000,1000
05/22/25,Food,Beverages,Soda,3,5000,15000,0,12000,3000
05/23/25,Food,Food,Takoyaki,3,10000,30000,0,24000,6000
05/23/25,Food,Food,Steak,4,60000,240000,0,220000,20000
05/23/25,Food,Food,Rendang,1,10000,10000,0,8000,2000
05/23/25,Food,Food,Fried Chicken,10,3000,30000,0,20000,10000
05/23/25,Food,Food,Noodles,8,6000,48000,0,40000,8000
05/23/25,Food,Food,Salmon,4,15000,60000,0,56000,4000
05/23/25,Food,Food,Macaroni,1,5000,5000,0,4000,1000
05/23/25,Food,Food,Fish & Chips,3,30000,90000,0,81000,9000
05/23/25,Food,Food,Burger,2,15000,30000,0,28000,2000
05/23/25,Food,Food,Hotdog,3,10000,30000,0,27000,3000
05/23/25,Food,Food,Pasta,1,18000,18000,0,16000,2000
05/23/25,Food,Snack,Chips,2,5000,10000,0,8000,2000
05/23/25,Food,Snack,Popcorn,1,7000,7000,0,6500,500
05/23/25,Food,Snack,Almonds,1,8000,8000,0,7000,1000
05/23/25,Food,Beverages,Lemon Tea,5,4000,20000,0,15000,5000
05/23/25,Food,Beverages,Ocha,2,4000,8000,0,7000,1000
05/23/25,Food,Beverages,Lychee Tea,3,6000,18000,0,15000,3000
05/23/25,Food,Beverages,Oolong Tea,1,6000,6000,0,5000,1000
05/23/25,Food,Beverages,Soda,3,5000,15000,0,12000,3000
05/24/25,Food,Food,Takoyaki,3,10000,30000,0,24000,6000
05/24/25,Food,Food,Steak,4,60000,240000,0,220000,20000
05/24/25,Food,Food,Rendang,1,10000,10000,0,8000,2000
05/24/25,Food,Food,Fried Chicken,10,3000,30000,0,20000,10000
05/24/25,Food,Food,Noodles,8,6000,48000,0,40000,8000
05/24/25,Food,Food,Salmon,4,15000,60000,0,56000,4000
05/24/25,Food,Food,Macaroni,1,5000,5000,0,4000,1000
05/24/25,Food,Food,Fish & Chips,3,30000,90000,0,81000,9000
05/24/25,Food,Food,Burger,2,15000,30000,0,28000,2000
05/24/25,Food,Food,Hotdog,3,10000,30000,0,27000,3000
05/24/25,Food,Food,Pasta,1,18000,18000,0,16000,2000
05/24/25,Food,Snack,Chips,2,5000,10000,0,8000,2000
05/24/25,Food,Snack,Popcorn,1,7000,7000,0,6500,500
05/24/25,Food,Snack,Almonds,1,8000,8000,0,7000,1000
05/24/25,Food,Beverages,Lemon Tea,5,4000,20000,0,15000,5000
05/24/25,Food,Beverages,Ocha,2,4000,8000,0,7000,1000
05/24/25,Food,Beverages,Lychee Tea,3,6000,18000,0,15000,3000
05/24/25,Food,Beverages,Oolong Tea,1,6000,6000,0,5000,1000
05/24/25,Food,Beverages,Soda,3,5000,15000,0,12000,3000
05/25/25,Food,Food,Takoyaki,3,10000,30000,0,24000,6000
05/25/25,Food,Food,Steak,4,60000,240000,0,220000,20000
05/25/25,Food,Food,Rendang,1,10000,10000,0,8000,2000
05/25/25,Food,Food,Fried Chicken,10,3000,30000,0,20000,10000
05/25/25,Food,Food,Noodles,8,6000,48000,0,40000,8000
05/25/25,Food,Food,Salmon,4,15000,60000,0,56000,4000
05/25/25,Food,Food,Macaroni,1,5000,5000,0,4000,1000
05/25/25,Food,Food,Fish & Chips,3,30000,90000,0,81000,9000
05/25/25,Food,Food,Burger,2,15000,30000,0,28000,2000
05/25/25,Food,Food,Hotdog,3,10000,30000,0,27000,3000
05/25/25,Food,Food,Pasta,1,18000,18000,0,16000,2000
05/25/25,Food,Snack,Chips,2,5000,10000,0,8000,2000
05/25/25,Food,Snack,Popcorn,1,7000,7000,0,6500,500
05/25/25,Food,Snack,Almonds,1,8000,8000,0,7000,1000
05/25/25,Food,Beverages,Lemon Tea,5,4000,20000,0,15000,5000
05/25/25,Food,Beverages,Ocha,2,4000,8000,0,7000,1000
05/25/25,Food,Beverages,Lychee Tea,3,6000,18000,0,15000,3000
05/25/25,Food,Beverages,Oolong Tea,1,6000,6000,0,5000,1000
05/25/25,Food,Beverages,Soda,3,5000,15000,0,12000,3000
05/26/25,Food,Food,Takoyaki,3,10000,30000,0,24000,6000
05/26/25,Food,Food,Steak,4,60000,240000,0,220000,20000
05/26/25,Food,Food,Rendang,1,10000,10000,0,8000,2000
05/26/25,Food,Food,Fried Chicken,10,3000,30000,0,20000,10000
05/26/25,Food,Food,Noodles,8,6000,48000,0,40000,8000
05/26/25,Food,Food,Salmon,4,15000,60000,0,56000,4000
05/26/25,Food,Food,Macaroni,1,5000,5000,0,4000,1000
05/26/25,Food,Food,Fish & Chips,3,30000,90000,0,81000,9000
05/26/25,Food,Food,Burger,2,15000,30000,0,28000,2000
05/26/25,Food,Food,Hotdog,3,10000,30000,0,27000,3000
05/26/25,Food,Food,Pasta,1,18000,18000,0,16000,2000
05/26/25,Food,Snack,Chips,2,5000,10000,0,8000,2000
05/26/25,Food,Snack,Popcorn,1,7000,7000,0,6500,500
05/26/25,Food,Snack,Almonds,1,8000,8000,0,7000,1000
05/26/25,Food,Beverages,Lemon Tea,5,4000,20000,0,15000,5000
05/26/25,Food,Beverages,Ocha,2,4000,8000,0,7000,1000
05/26/25,Food,Beverages,Lychee Tea,3,6000,18000,0,15000,3000
05/26/25,Food,Beverages,Oolong Tea,1,6000,6000,0,5000,1000
05/26/25,Food,Beverages,Soda,3,5000,15000,0,12000,3000
05/27/25,Food,Food,Takoyaki,3,10000,30000,0,24000,6000
05/27/25,Food,Food,Steak,4,60000,240000,0,220000,20000
05/27/25,Food,Food,Rendang,1,10000,10000,0,8000,2000
05/27/25,Food,Food,Fried Chicken,10,3000,30000,0,20000,10000
05/27/25,Food,Food,Noodles,8,6000,48000,0,40000,8000
05/27/25,Food,Food,Salmon,4,15000,60000,0,56000,4000
05/27/25,Food,Food,Macaroni,1,5000,5000,0,4000,1000
05/27/25,Food,Food,Fish & Chips,3,30000,90000,0,81000,9000
05/27/25,Food,Food,Burger,2,15000,30000,0,28000,2000
05/27/25,Food,Food,Hotdog,3,10000,30000,0,27000,3000
05/27/25,Food,Food,Pasta,1,18000,18000,0,16000,2000
05/27/25,Food,Snack,Chips,2,5000,10000,0,8000,2000
05/27/25,Food,Snack,Popcorn,1,7000,7000,0,6500,500
05/27/25,Food,Snack,Almonds,1,8000,8000,0,7000,1000
05/27/25,Food,Beverages,Lemon Tea,5,4000,20000,0,15000,5000
05/27/25,Food,Beverages,Ocha,2,4000,8000,0,7000,1000
05/27/25,Food,Beverages,Lychee Tea,3,6000,18000,0,15000,3000
05/27/25,Food,Beverages,Oolong Tea,1,6000,6000,0,5000,1000
05/27/25,Food,Beverages,Soda,3,5000,15000,0,12000,3000
05/28/25,Food,Food,Takoyaki,3,10000,30000,0,24000,6000
05/28/25,Food,Food,Steak,4,60000,240000,0,220000,20000
05/28/25,Food,Food,Rendang,1,10000,10000,0,8000,2000
05/28/25,Food,Food,Fried Chicken,10,3000,30000,0,20000,10000
05/28/25,Food,Food,Noodles,8,6000,48000,0,40000,8000
05/28/25,Food,Food,Salmon,4,15000,60000,0,56000,4000
05/28/25,Food,Food,Macaroni,1,5000,5000,0,4000,1000
05/28/25,Food,Food,Fish & Chips,3,30000,90000,0,81000,9000
05/28/25,Food,Food,Burger,2,15000,30000,0,28000,2000
05/28/25,Food,Food,Hotdog,3,10000,30000,0,27000,3000
05/28/25,Food,Food,Pasta,1,18000,18000,0,16000,2000
05/28/25,Food,Snack,Chips,2,5000,10000,0,8000,2000
05/28/25,Food,Snack,Popcorn,1,7000,7000,0,6500,500
05/28/25,Food,Snack,Almonds,1,8000,8000,0,7000,1000
05/28/25,Food,Beverages,Lemon Tea,5,4000,20000,0,15000,5000
05/28/25,Food,Beverages,Ocha,2,4000,8000,0,7000,1000
05/28/25,Food,Beverages,Lychee Tea,3,6000,18000,0,15000,3000
05/28/25,Food,Beverages,Oolong Tea,1,6000,6000,0,5000,1000
05/28/25,Food,Beverages,Soda,3,5000,15000,0,12000,3000
05/29/25,Food,Food,Takoyaki,3,10000,30000,0,24000,6000
05/29/25,Food,Food,Steak,4,60000,240000,0,220000,20000
05/29/25,Food,Food,Rendang,1,10000,10000,0,8000,2000
05/29/25,Food,Food,Fried Chicken,10,3000,30000,0,20000,10000
05/29/25,Food,Food,Noodles,8,6000,48000,0,40000,8000
05/29/25,Food,Food,Salmon,4,15000,60000,0,56000,4000
05/29/25,Food,Food,Macaroni,1,5000,5000,0,4000,1000
05/29/25,Food,Food,Fish & Chips,3,30000,90000,0,81000,9000
05/29/25,Food,Food,Burger,2,15000,30000,0,28000,2000
05/29/25,Food,Food,Hotdog,3,10000,30000,0,27000,3000
05/29/25,Food,Food,Pasta,1,18000,18000,0,16000,2000
05/29/25,Food,Snack,Chips,2,5000,10000,0,8000,2000
05/29/25,Food,Snack,Popcorn,1,7000,7000,0,6500,500
05/29/25,Food,Snack,Almonds,1,8000,8000,0,7000,1000
05/29/25,Food,Beverages,Lemon Tea,5,4000,20000,0,15000,5000
05/29/25,Food,Beverages,Ocha,2,4000,8000,0,7000,1000
05/29/25,Food,Beverages,Lychee Tea,3,6000,18000,0,15000,3000
05/29/25,Food,Beverages,Oolong Tea,1,6000,6000,0,5000,1000
05/29/25,Food,Beverages,Soda,3,5000,15000,0,12000,3000
05/30/25,Food,Food,Takoyaki,3,10000,30000,0,24000,6000
05/30/25,Food,Food,Steak,4,60000,240000,0,220000,20000
05/30/25,Food,Food,Rendang,1,10000,10000,0,8000,2000
05/30/25,Food,Food,Fried Chicken,10,3000,30000,0,20000,10000
05/30/25,Food,Food,Noodles,8,6000,48000,0,40000,8000
05/30/25,Food,Food,Salmon,4,15000,60000,0,56000,4000
05/30/25,Food,Food,Macaroni,1,5000,5000,0,4000,1000
05/30/25,Food,Food,Fish & Chips,3,30000,90000,0,81000,9000
05/30/25,Food,Food,Burger,2,15000,30000,0,28000,2000
05/30/25,Food,Food,Hotdog,3,10000,30000,0,27000,3000
05/30/25,Food,Food,Pasta,1,18000,18000,0,16000,2000
05/30/25,Food,Snack,Chips,2,5000,10000,0,8000,2000
05/30/25,Food,Snack,Popcorn,1,7000,7000,0,6500,500
05/30/25,Food,Snack,Almonds,1,8000,8000,0,7000,1000
05/30/25,Food,Beverages,Lemon Tea,5,4000,20000,0,15000,5000
05/30/25,Food,Beverages,Ocha,2,4000,8000,0,7000,1000
05/30/25,Food,Beverages,Lychee Tea,3,6000,18000,0,15000,3000
05/30/25,Food,Beverages,Oolong Tea,1,6000,6000,0,5000,1000
05/30/25,Food,Beverages,Soda,3,5000,15000,0,12000,3000
05/31/25,Food,Food,Takoyaki,3,10000,30000,0,24000,6000
05/31/25,Food,Food,Steak,4,60000,240000,0,220000,20000
05/31/25,Food,Food,Rendang,1,10000,10000,0,8000,2000
05/31/25,Food,Food,Fried Chicken,10,3000,30000,0,20000,10000
05/31/25,Food,Food,Noodles,8,6000,48000,0,40000,8000
05/31/25,Food,Food,Salmon,4,15000,60000,0,56000,4000
05/31/25,Food,Food,Macaroni,1,5000,5000,0,4000,1000
05/31/25,Food,Food,Fish & Chips,3,30000,90000,0,81000,9000
05/31/25,Food,Food,Burger,2,15000,30000,0,28000,2000
05/31/25,Food,Food,Hotdog,3,10000,30000,0,27000,3000
05/31/25,Food,Food,Pasta,1,18000,18000,0,16000,2000
05/31/25,Food,Snack,Chips,2,5000,10000,0,8000,2000
05/31/25,Food,Snack,Popcorn,1,7000,7000,0,6500,500
05/31/25,Food,Snack,Almonds,1,8000,8000,0,7000,1000
05/31/25,Food,Beverages,Lemon Tea,5,4000,20000,0,15000,5000
05/31/25,Food,Beverages,Ocha,2,4000,8000,0,7000,1000
05/31/25,Food,Beverages,Lychee Tea,3,6000,18000,0,15000,3000
05/31/25,Food,Beverages,Oolong Tea,1,6000,6000,0,5000,1000
05/31/25,Food,Beverages,Soda,3,5000,15000,0,12000,3000
06/01/25,Food,Food,Takoyaki,3,10000,30000,0,24000,6000
06/01/25,Food,Food,Steak,4,60000,240000,0,220000,20000
06/01/25,Food,Food,Rendang,1,10000,10000,0,8000,2000
06/01/25,Food,Food,Fried Chicken,10,3000,30000,0,20000,10000
06/01/25,Food,Food,Noodles,8,6000,48000,0,40000,8000
06/01/25,Food,Food,Salmon,4,15000,60000,0,56000,4000
06/01/25,Food,Food,Macaroni,1,5000,5000,0,4000,1000
06/01/25,Food,Food,Fish & Chips,3,30000,90000,0,81000,9000
06/01/25,Food,Food,Burger,2,15000,30000,0,28000,2000
06/01/25,Food,Food,Hotdog,3,10000,30000,0,27000,3000
06/01/25,Food,Food,Pasta,1,18000,18000,0,16000,2000
06/01/25,Food,Snack,Chips,2,5000,10000,0,8000,2000
06/01/25,Food,Snack,Popcorn,1,7000,7000,0,6500,500
06/01/25,Food,Snack,Almonds,1,8000,8000,0,7000,1000
06/01/25,Food,Beverages,Lemon Tea,5,4000,20000,0,15000,5000
06/01/25,Food,Beverages,Ocha,2,4000,8000,0,7000,1000
06/01/25,Food,Beverages,Lychee Tea,3,6000,18000,0,15000,3000
06/01/25,Food,Beverages,Oolong Tea,1,6000,6000,0,5000,1000
06/01/25,Food,Beverages,Soda,3,5000,15000,0,12000,3000
06/02/25,Food,Food,Takoyaki,3,10000,30000,0,24000,6000
06/02/25,Food,Food,Steak,4,60000,240000,0,220000,20000
06/02/25,Food,Food,Rendang,1,10000,10000,0,8000,2000
06/02/25,Food,Food,Fried Chicken,10,3000,30000,0,20000,10000
06/02/25,Food,Food,Noodles,8,6000,48000,0,40000,8000
06/02/25,Food,Food,Salmon,4,15000,60000,0,56000,4000
06/02/25,Food,Food,Macaroni,1,5000,5000,0,4000,1000
06/02/25,Food,Food,Fish & Chips,3,30000,90000,0,81000,9000
06/02/25,Food,Food,Burger,2,15000,30000,0,28000,2000
06/02/25,Food,Food,Hotdog,3,10000,30000,0,27000,3000
06/02/25,Food,Food,Pasta,1,18000,18000,0,16000,2000
06/02/25,Food,Snack,Chips,2,5000,10000,0,8000,2000
06/02/25,Food,Snack,Popcorn,1,7000,7000,0,6500,500
06/02/25,Food,Snack,Almonds,1,8000,8000,0,7000,1000
06/02/25,Food,Beverages,Lemon Tea,5,4000,20000,0,15000,5000
06/02/25,Food,Beverages,Ocha,2,4000,8000,0,7000,1000
06/02/25,Food,Beverages,Lychee Tea,3,6000,18000,0,15000,3000
06/02/25,Food,Beverages,Oolong Tea,1,6000,6000,0,5000,1000
06/02/25,Food,Beverages,Soda,3,5000,15000,0,12000,3000
06/03/25,Food,Food,Takoyaki,3,10000,30000,0,24000,6000
06/03/25,Food,Food,Steak,4,60000,240000,0,220000,20000
06/03/25,Food,Food,Rendang,1,10000,10000,0,8000,2000
06/03/25,Food,Food,Fried Chicken,10,3000,30000,0,20000,10000
06/03/25,Food,Food,Noodles,8,6000,48000,0,40000,8000
06/03/25,Food,Food,Salmon,4,15000,60000,0,56000,4000
06/03/25,Food,Food,Macaroni,1,5000,5000,0,4000,1000
06/03/25,Food,Food,Fish & Chips,3,30000,90000,0,81000,9000
06/03/25,Food,Food,Burger,2,15000,30000,0,28000,2000
06/03/25,Food,Food,Hotdog,3,10000,30000,0,27000,3000
06/03/25,Food,Food,Pasta,1,18000,18000,0,16000,2000
06/03/25,Food,Snack,Chips,2,5000,10000,0,8000,2000
06/03/25,Food,Snack,Popcorn,1,7000,7000,0,6500,500
06/03/25,Food,Snack,Almonds,1,8000,8000,0,7000,1000
06/03/25,Food,Beverages,Lemon Tea,5,4000,20000,0,15000,5000
06/03/25,Food,Beverages,Ocha,2,4000,8000,0,7000,1000
06/03/25,Food,Beverages,Lychee Tea,3,6000,18000,0,15000,3000
06/03/25,Food,Beverages,Oolong Tea,1,6000,6000,0,5000,1000
06/03/25,Food,Beverages,Soda,3,5000,15000,0,12000,3000
06/04/25,Food,Food,Takoyaki,3,10000,30000,0,24000,6000
06/04/25,Food,Food,Steak,4,60000,240000,0,220000,20000
06/04/25,Food,Food,Rendang,1,10000,10000,0,8000,2000
06/04/25,Food,Food,Fried Chicken,10,3000,30000,0,20000,10000
06/04/25,Food,Food,Noodles,8,6000,48000,0,40000,8000
06/04/25,Food,Food,Salmon,4,15000,60000,0,56000,4000
06/04/25,Food,Food,Macaroni,1,5000,5000,0,4000,1000
06/04/25,Food,Food,Fish & Chips,3,30000,90000,0,81000,9000
06/04/25,Food,Food,Burger,2,15000,30000,0,28000,2000
06/04/25,Food,Food,Hotdog,3,10000,30000,0,27000,3000
06/04/25,Food,Food,Pasta,1,18000,18000,0,16000,2000
06/04/25,Food,Snack,Chips,2,5000,10000,0,8000,2000
06/04/25,Food,Snack,Popcorn,1,7000,7000,0,6500,500
06/04/25,Food,Snack,Almonds,1,8000,8000,0,7000,1000
06/04/25,Food,Beverages,Lemon Tea,5,4000,20000,0,15000,5000
06/04/25,Food,Beverages,Ocha,2,4000,8000,0,7000,1000
06/04/25,Food,Beverages,Lychee Tea,3,6000,18000,0,15000,3000
06/04/25,Food,Beverages,Oolong Tea,1,6000,6000,0,5000,1000
06/04/25,Food,Beverages,Soda,3,5000,15000,0,12000,3000
06/05/25,Food,Food,Takoyaki,3,10000,30000,0,24000,6000
06/05/25,Food,Food,Steak,4,60000,240000,0,220000,20000
06/05/25,Food,Food,Rendang,1,10000,10000,0,8000,2000
06/05/25,Food,Food,Fried Chicken,10,3000,30000,0,20000,10000
06/05/25,Food,Food,Noodles,8,6000,48000,0,40000,8000
06/05/25,Food,Food,Salmon,4,15000,60000,0,56000,4000
06/05/25,Food,Food,Macaroni,1,5000,5000,0,4000,1000
06/05/25,Food,Food,Fish & Chips,3,30000,90000,0,81000,9000
06/05/25,Food,Food,Burger,2,15000,30000,0,28000,2000
06/05/25,Food,Food,Hotdog,3,10000,30000,0,27000,3000
06/05/25,Food,Food,Pasta,1,18000,18000,0,16000,2000
06/05/25,Food,Snack,Chips,2,5000,10000,0,8000,2000
06/05/25,Food,Snack,Popcorn,1,7000,7000,0,6500,500
06/05/25,Food,Snack,Almonds,1,8000,8000,0,7000,1000
06/05/25,Food,Beverages,Lemon Tea,5,4000,20000,0,15000,5000
06/05/25,Food,Beverages,Ocha,2,4000,8000,0,7000,1000
06/05/25,Food,Beverages,Lychee Tea,3,6000,18000,0,15000,3000
06/05/25,Food,Beverages,Oolong Tea,1,6000,6000,0,5000,1000
06/05/25,Food,Beverages,Soda,3,5000,15000,0,12000,3000
06/06/25,Food,Food,Takoyaki,3,10000,30000,0,24000,6000
06/06/25,Food,Food,Steak,4,60000,240000,0,220000,20000
06/06/25,Food,Food,Rendang,1,10000,10000,0,8000,2000
06/06/25,Food,Food,Fried Chicken,10,3000,30000,0,20000,10000
06/06/25,Food,Food,Noodles,8,6000,48000,0,40000,8000
06/06/25,Food,Food,Salmon,4,15000,60000,0,56000,4000
06/06/25,Food,Food,Macaroni,1,5000,5000,0,4000,1000
06/06/25,Food,Food,Fish & Chips,3,30000,90000,0,81000,9000
06/06/25,Food,Food,Burger,2,15000,30000,0,28000,2000
06/06/25,Food,Food,Hotdog,3,10000,30000,0,27000,3000
06/06/25,Food,Food,Pasta,1,18000,18000,0,16000,2000
06/06/25,Food,Snack,Chips,2,5000,10000,0,8000,2000
06/06/25,Food,Snack,Popcorn,1,7000,7000,0,6500,500
06/06/25,Food,Snack,Almonds,1,8000,8000,0,7000,1000
06/06/25,Food,Beverages,Lemon Tea,5,4000,20000,0,15000,5000
06/06/25,Food,Beverages,Ocha,2,4000,8000,0,7000,1000
06/06/25,Food,Beverages,Lychee Tea,3,6000,18000,0,15000,3000
06/06/25,Food,Beverages,Oolong Tea,1,6000,6000,0,5000,1000
06/06/25,Food,Beverages,Soda,3,5000,15000,0,12000,3000
06/07/25,Food,Food,Takoyaki,3,10000,30000,0,24000,6000
06/07/25,Food,Food,Steak,4,60000,240000,0,220000,20000
06/07/25,Food,Food,Rendang,1,10000,10000,0,8000,2000
06/07/25,Food,Food,Fried Chicken,10,3000,30000,0,20000,10000
06/07/25,Food,Food,Noodles,8,6000,48000,0,40000,8000
06/07/25,Food,Food,Salmon,4,15000,60000,0,56000,4000
06/07/25,Food,Food,Macaroni,1,5000,5000,0,4000,1000
06/07/25,Food,Food,Fish & Chips,3,30000,90000,0,81000,9000
06/07/25,Food,Food,Burger,2,15000,30000,0,28000,2000
06/07/25,Food,Food,Hotdog,3,10000,30000,0,27000,3000
06/07/25,Food,Food,Pasta,1,18000,18000,0,16000,2000
06/07/25,Food,Snack,Chips,2,5000,10000,0,8000,2000
06/07/25,Food,Snack,Popcorn,1,7000,7000,0,6500,500
06/07/25,Food,Snack,Almonds,1,8000,8000,0,7000,1000
06/07/25,Food,Beverages,Lemon Tea,5,4000,20000,0,15000,5000
06/07/25,Food,Beverages,Ocha,2,4000,8000,0,7000,1000
06/07/25,Food,Beverages,Lychee Tea,3,6000,18000,0,15000,3000
06/07/25,Food,Beverages,Oolong Tea,1,6000,6000,0,5000,1000
06/07/25,Food,Beverages,Soda,3,5000,15000,0,12000,3000
06/08/25,Food,Food,Takoyaki,3,10000,30000,0,24000,6000
06/08/25,Food,Food,Steak,4,60000,240000,0,220000,20000
06/08/25,Food,Food,Rendang,1,10000,10000,0,8000,2000
06/08/25,Food,Food,Fried Chicken,10,3000,30000,0,20000,10000
06/08/25,Food,Food,Noodles,8,6000,48000,0,40000,8000
06/08/25,Food,Food,Salmon,4,15000,60000,0,56000,4000
06/08/25,Food,Food,Macaroni,1,5000,5000,0,4000,1000
06/08/25,Food,Food,Fish & Chips,3,30000,90000,0,81000,9000
06/08/25,Food,Food,Burger,2,15000,30000,0,28000,2000
06/08/25,Food,Food,Hotdog,3,10000,30000,0,27000,3000
06/08/25,Food,Food,Pasta,1,18000,18000,0,16000,2000
06/08/25,Food,Snack,Chips,2,5000,10000,0,8000,2000
06/08/25,Food,Snack,Popcorn,1,7000,7000,0,6500,500
06/08/25,Food,Snack,Almonds,1,8000,8000,0,7000,1000
06/08/25,Food,Beverages,Lemon Tea,5,4000,20000,0,15000,5000
06/08/25,Food,Beverages,Ocha,2,4000,8000,0,7000,1000
06/08/25,Food,Beverages,Lychee Tea,3,6000,18000,0,15000,3000
06/08/25,Food,Beverages,Oolong Tea,1,6000,6000,0,5000,1000
06/08/25,Food,Beverages,Soda,3,5000,15000,0,12000,3000
06/09/25,Food,Food,Takoyaki,3,10000,30000,0,24000,6000
06/09/25,Food,Food,Steak,4,60000,240000,0,220000,20000
06/09/25,Food,Food,Rendang,1,10000,10000,0,8000,2000
06/09/25,Food,Food,Fried Chicken,10,3000,30000,0,20000,10000
06/09/25,Food,Food,Noodles,8,6000,48000,0,40000,8000
06/09/25,Food,Food,Salmon,4,15000,60000,0,56000,4000
06/09/25,Food,Food,Macaroni,1,5000,5000,0,4000,1000
06/09/25,Food,Food,Fish & Chips,3,30000,90000,0,81000,9000
06/09/25,Food,Food,Burger,2,15000,30000,0,28000,2000
06/09/25,Food,Food,Hotdog,3,10000,30000,0,27000,3000
06/09/25,Food,Food,Pasta,1,18000,18000,0,16000,2000
06/09/25,Food,Snack,Chips,2,5000,10000,0,8000,2000
06/09/25,Food,Snack,Popcorn,1,7000,7000,0,6500,500
06/09/25,Food,Snack,Almonds,1,8000,8000,0,7000,1000
06/09/25,Food,Beverages,Lemon Tea,5,4000,20000,0,15000,5000
06/09/25,Food,Beverages,Ocha,2,4000,8000,0,7000,1000
06/09/25,Food,Beverages,Lychee Tea,3,6000,18000,0,15000,3000
06/09/25,Food,Beverages,Oolong Tea,1,6000,6000,0,5000,1000
06/09/25,Food,Beverages,Soda,3,5000,15000,0,12000,3000
06/10/25,Food,Food,Takoyaki,3,10000,30000,0,24000,6000
06/10/25,Food,Food,Steak,4,60000,240000,0,220000,20000
06/10/25,Food,Food,Rendang,1,10000,10000,0,8000,2000
06/10/25,Food,Food,Fried Chicken,10,3000,30000,0,20000,10000
06/10/25,Food,Food,Noodles,8,6000,48000,0,40000,8000
06/10/25,Food,Food,Salmon,4,15000,60000,0,56000,4000
06/10/25,Food,Food,Macaroni,1,5000,5000,0,4000,1000
06/10/25,Food,Food,Fish & Chips,3,30000,90000,0,81000,9000
06/10/25,Food,Food,Burger,2,15000,30000,0,28000,2000
06/10/25,Food,Food,Hotdog,3,10000,30000,0,27000,3000
06/10/25,Food,Food,Pasta,1,18000,18000,0,16000,2000
06/10/25,Food,Snack,Chips,2,5000,10000,0,8000,2000
06/10/25,Food,Snack,Popcorn,1,7000,7000,0,6500,500
06/10/25,Food,Snack,Almonds,1,8000,8000,0,7000,1000
06/10/25,Food,Beverages,Lemon Tea,5,4000,20000,0,15000,5000
06/10/25,Food,Beverages,Ocha,2,4000,8000,0,7000,1000
06/10/25,Food,Beverages,Lychee Tea,3,6000,18000,0,15000,3000
06/10/25,Food,Beverages,Oolong Tea,1,6000,6000,0,5000,1000
06/10/25,Food,Beverages,Soda,3,5000,15000,0,12000,3000
06/11/25,Food,Food,Takoyaki,3,10000,30000,0,24000,6000
06/11/25,Food,Food,Steak,4,60000,240000,0,220000,20000
06/11/25,Food,Food,Rendang,1,10000,10000,0,8000,2000
06/11/25,Food,Food,Fried Chicken,10,3000,30000,0,20000,10000
06/11/25,Food,Food,Noodles,8,6000,48000,0,40000,8000
06/11/25,Food,Food,Salmon,4,15000,60000,0,56000,4000
06/11/25,Food,Food,Macaroni,1,5000,5000,0,4000,1000
06/11/25,Food,Food,Fish & Chips,3,30000,90000,0,81000,9000
06/11/25,Food,Food,Burger,2,15000,30000,0,28000,2000
06/11/25,Food,Food,Hotdog,3,10000,30000,0,27000,3000
06/11/25,Food,Food,Pasta,1,18000,18000,0,16000,2000
06/11/25,Food,Snack,Chips,2,5000,10000,0,8000,2000
06/11/25,Food,Snack,Popcorn,1,7000,7000,0,6500,500
06/11/25,Food,Snack,Almonds,1,8000,8000,0,7000,1000
06/11/25,Food,Beverages,Lemon Tea,5,4000,20000,0,15000,5000
06/11/25,Food,Beverages,Ocha,2,4000,8000,0,7000,1000
06/11/25,Food,Beverages,Lychee Tea,3,6000,18000,0,15000,3000
06/11/25,Food,Beverages,Oolong Tea,1,6000,6000,0,5000,1000
06/11/25,Food,Beverages,Soda,3,5000,15000,0,12000,3000
06/12/25,Food,Food,Takoyaki,3,10000,30000,0,24000,6000
06/12/25,Food,Food,Steak,4,60000,240000,0,220000,20000
06/12/25,Food,Food,Rendang,1,10000,10000,0,8000,2000
06/12/25,Food,Food,Fried Chicken,10,3000,30000,0,20000,10000
06/12/25,Food,Food,Noodles,8,6000,48000,0,40000,8000
06/12/25,Food,Food,Salmon,4,15000,60000,0,56000,4000
06/12/25,Food,Food,Macaroni,1,5000,5000,0,4000,1000
06/12/25,Food,Food,Fish & Chips,3,30000,90000,0,81000,9000
06/12/25,Food,Food,Burger,2,15000,30000,0,28000,2000
06/12/25,Food,Food,Hotdog,3,10000,30000,0,27000,3000
06/12/25,Food,Food,Pasta,1,18000,18000,0,16000,2000
06/12/25,Food,Snack,Chips,2,5000,10000,0,8000,2000
06/12/25,Food,Snack,Popcorn,1,7000,7000,0,6500,500
06/12/25,Food,Snack,Almonds,1,8000,8000,0,7000,1000
06/12/25,Food,Beverages,Lemon Tea,5,4000,20000,0,15000,5000
06/12/25,Food,Beverages,Ocha,2,4000,8000,0,7000,1000
06/12/25,Food,Beverages,Lychee Tea,3,6000,18000,0,15000,3000
06/12/25,Food,Beverages,Oolong Tea,1,6000,6000,0,5000,1000
06/12/25,Food,Beverages,Soda,3,5000,15000,0,12000,3000
06/13/25,Food,Food,Takoyaki,3,10000,30000,0,24000,6000
06/13/25,Food,Food,Steak,4,60000,240000,0,220000,20000
06/13/25,Food,Food,Rendang,1,10000,10000,0,8000,2000
06/13/25,Food,Food,Fried Chicken,10,3000,30000,0,20000,10000
06/13/25,Food,Food,Noodles,8,6000,48000,0,40000,8000
06/13/25,Food,Food,Salmon,4,15000,60000,0,56000,4000
06/13/25,Food,Food,Macaroni,1,5000,5000,0,4000,1000
06/13/25,Food,Food,Fish & Chips,3,30000,90000,0,81000,9000
06/13/25,Food,Food,Burger,2,15000,30000,0,28000,2000
06/13/25,Food,Food,Hotdog,3,10000,30000,0,27000,3000
06/13/25,Food,Food,Pasta,1,18000,18000,0,16000,2000
06/13/25,Food,Snack,Chips,2,5000,10000,0,8000,2000
06/13/25,Food,Snack,Popcorn,1,7000,7000,0,6500,500
06/13/25,Food,Snack,Almonds,1,8000,8000,0,7000,1000
06/13/25,Food,Beverages,Lemon Tea,5,4000,20000,0,15000,5000
06/13/25,Food,Beverages,Ocha,2,4000,8000,0,7000,1000
06/13/25,Food,Beverages,Lychee Tea,3,6000,18000,0,15000,3000
06/13/25,Food,Beverages,Oolong Tea,1,6000,6000,0,5000,1000
06/13/25,Food,Beverages,Soda,3,5000,15000,0,12000,3000
06/14/25,Food,Food,Takoyaki,3,10000,30000,0,24000,6000
06/14/25,Food,Food,Steak,4,60000,240000,0,220000,20000
06/14/25,Food,Food,Rendang,1,10000,10000,0,8000,2000
06/14/25,Food,Food,Fried Chicken,10,3000,30000,0,20000,10000
06/14/25,Food,Food,Noodles,8,6000,48000,0,40000,8000
06/14/25,Food,Food,Salmon,4,15000,60000,0,56000,4000
06/14/25,Food,Food,Macaroni,1,5000,5000,0,4000,1000
06/14/25,Food,Food,Fish & Chips,3,30000,90000,0,81000,9000
06/14/25,Food,Food,Burger,2,15000,30000,0,28000,2000
06/14/25,Food,Food,Hotdog,3,10000,30000,0,27000,3000
06/14/25,Food,Food,Pasta,1,18000,18000,0,16000,2000
06/14/25,Food,Snack,Chips,2,5000,10000,0,8000,2000
06/14/25,Food,Snack,Popcorn,1,7000,7000,0,6500,500
06/14/25,Food,Snack,Almonds,1,8000,8000,0,7000,1000
06/14/25,Food,Beverages,Lemon Tea,5,4000,20000,0,15000,5000
06/14/25,Food,Beverages,Ocha,2,4000,8000,0,7000,1000
06/14/25,Food,Beverages,Lychee Tea,3,6000,18000,0,15000,3000
06/14/25,Food,Beverages,Oolong Tea,1,6000,6000,0,5000,1000
06/14/25,Food,Beverages,Soda,3,5000,15000,0,12000,3000
06/15/25,Food,Food,Takoyaki,3,10000,30000,0,24000,6000
06/15/25,Food,Food,Steak,4,60000,240000,0,220000,20000
06/15/25,Food,Food,Rendang,1,10000,10000,0,8000,2000
06/15/25,Food,Food,Fried Chicken,10,3000,30000,0,20000,10000
06/15/25,Food,Food,Noodles,8,6000,48000,0,40000,8000
06/15/25,Food,Food,Salmon,4,15000,60000,0,56000,4000
06/15/25,Food,Food,Macaroni,1,5000,5000,0,4000,1000
06/15/25,Food,Food,Fish & Chips,3,30000,90000,0,81000,9000
06/15/25,Food,Food,Burger,2,15000,30000,0,28000,2000
06/15/25,Food,Food,Hotdog,3,10000,30000,0,27000,3000
06/15/25,Food,Food,Pasta,1,18000,18000,0,16000,2000
06/15/25,Food,Snack,Chips,2,5000,10000,0,8000,2000
06/15/25,Food,Snack,Popcorn,1,7000,7000,0,6500,500
06/15/25,Food,Snack,Almonds,1,8000,8000,0,7000,1000
06/15/25,Food,Beverages,Lemon Tea,5,4000,20000,0,15000,5000
06/15/25,Food,Beverages,Ocha,2,4000,8000,0,7000,1000
06/15/25,Food,Beverages,Lychee Tea,3,6000,18000,0,15000,3000
06/15/25,Food,Beverages,Oolong Tea,1,6000,6000,0,5000,1000
06/15/25,Food,Beverages,Soda,3,5000,15000,0,12000,3000
06/16/25,Food,Food,Takoyaki,3,10000,30000,0,24000,6000
06/16/25,Food,Food,Steak,4,60000,240000,0,220000,20000
06/16/25,Food,Food,Rendang,1,10000,10000,0,8000,2000
06/16/25,Food,Food,Fried Chicken,10,3000,30000,0,20000,10000
06/16/25,Food,Food,Noodles,8,6000,48000,0,40000,8000
06/16/25,Food,Food,Salmon,4,15000,60000,0,56000,4000
06/16/25,Food,Food,Macaroni,1,5000,5000,0,4000,1000
06/16/25,Food,Food,Fish & Chips,3,30000,90000,0,81000,9000
06/16/25,Food,Food,Burger,2,15000,30000,0,28000,2000
06/16/25,Food,Food,Hotdog,3,10000,30000,0,27000,3000
06/16/25,Food,Food,Pasta,1,18000,18000,0,16000,2000
06/16/25,Food,Snack,Chips,2,5000,10000,0,8000,2000
06/16/25,Food,Snack,Popcorn,1,7000,7000,0,6500,500
06/16/25,Food,Snack,Almonds,1,8000,8000,0,7000,1000
06/16/25,Food,Beverages,Lemon Tea,5,4000,20000,0,15000,5000
06/16/25,Food,Beverages,Ocha,2,4000,8000,0,7000,1000
06/16/25,Food,Beverages,Lychee Tea,3,6000,18000,0,15000,3000
06/16/25,Food,Beverages,Oolong Tea,1,6000,6000,0,5000,1000
06/16/25,Food,Beverages,Soda,3,5000,15000,0,12000,3000
06/17/25,Food,Food,Takoyaki,3,10000,30000,0,24000,6000
06/17/25,Food,Food,Steak,4,60000,240000,0,220000,20000
06/17/25,Food,Food,Rendang,1,10000,10000,0,8000,2000
06/17/25,Food,Food,Fried Chicken,10,3000,30000,0,20000,10000
06/17/25,Food,Food,Noodles,8,6000,48000,0,40000,8000
06/17/25,Food,Food,Salmon,4,15000,60000,0,56000,4000
06/17/25,Food,Food,Macaroni,1,5000,5000,0,4000,1000
06/17/25,Food,Food,Fish & Chips,3,30000,90000,0,81000,9000
06/17/25,Food,Food,Burger,2,15000,30000,0,28000,2000
06/17/25,Food,Food,Hotdog,3,10000,30000,0,27000,3000
06/17/25,Food,Food,Pasta,1,18000,18000,0,16000,2000
06/17/25,Food,Snack,Chips,2,5000,10000,0,8000,2000
06/17/25,Food,Snack,Popcorn,1,7000,7000,0,6500,500
06/17/25,Food,Snack,Almonds,1,8000,8000,0,7000,1000
06/17/25,Food,Beverages,Lemon Tea,5,4000,20000,0,15000,5000
06/17/25,Food,Beverages,Ocha,2,4000,8000,0,7000,1000
06/17/25,Food,Beverages,Lychee Tea,3,6000,18000,0,15000,3000
06/17/25,Food,Beverages,Oolong Tea,1,6000,6000,0,5000,1000
06/17/25,Food,Beverages,Soda,3,5000,15000,0,12000,3000
06/18/25,Food,Food,Takoyaki,3,10000,30000,0,24000,6000
06/18/25,Food,Food,Steak,4,60000,240000,0,220000,20000
06/18/25,Food,Food,Rendang,1,10000,10000,0,8000,2000
06/18/25,Food,Food,Fried Chicken,10,3000,30000,0,20000,10000
06/18/25,Food,Food,Noodles,8,6000,48000,0,40000,8000
06/18/25,Food,Food,Salmon,4,15000,60000,0,56000,4000
06/18/25,Food,Food,Macaroni,1,5000,5000,0,4000,1000
06/18/25,Food,Food,Fish & Chips,3,30000,90000,0,81000,9000
06/18/25,Food,Food,Burger,2,15000,30000,0,28000,2000
06/18/25,Food,Food,Hotdog,3,10000,30000,0,27000,3000
06/18/25,Food,Food,Pasta,1,18000,18000,0,16000,2000
06/18/25,Food,Snack,Chips,2,5000,10000,0,8000,2000
06/18/25,Food,Snack,Popcorn,1,7000,7000,0,6500,500
06/18/25,Food,Snack,Almonds,1,8000,8000,0,7000,1000
06/18/25,Food,Beverages,Lemon Tea,5,4000,20000,0,15000,5000
06/18/25,Food,Beverages,Ocha,2,4000,8000,0,7000,1000
06/18/25,Food,Beverages,Lychee Tea,3,6000,18000,0,15000,3000
06/18/25,Food,Beverages,Oolong Tea,1,6000,6000,0,5000,1000
06/18/25,Food,Beverages,Soda,3,5000,15000,0,12000,3000
06/19/25,Food,Food,Takoyaki,3,10000,30000,0,24000,6000
06/19/25,Food,Food,Steak,4,60000,240000,0,220000,20000
06/19/25,Food,Food,Rendang,1,10000,10000,0,8000,2000
06/19/25,Food,Food,Fried Chicken,10,3000,30000,0,20000,10000
06/19/25,Food,Food,Noodles,8,6000,48000,0,40000,8000
06/19/25,Food,Food,Salmon,4,15000,60000,0,56000,4000
06/19/25,Food,Food,Macaroni,1,5000,5000,0,4000,1000
06/19/25,Food,Food,Fish & Chips,3,30000,90000,0,81000,9000
06/19/25,Food,Food,Burger,2,15000,30000,0,28000,2000
06/19/25,Food,Food,Hotdog,3,10000,30000,0,27000,3000
06/19/25,Food,Food,Pasta,1,18000,18000,0,16000,2000
06/19/25,Food,Snack,Chips,2,5000,10000,0,8000,2000
06/19/25,Food,Snack,Popcorn,1,7000,7000,0,6500,500
06/19/25,Food,Snack,Almonds,1,8000,8000,0,7000,1000
06/19/25,Food,Beverages,Lemon Tea,5,4000,20000,0,15000,5000
06/19/25,Food,Beverages,Ocha,2,4000,8000,0,7000,1000
06/19/25,Food,Beverages,Lychee Tea,3,6000,18000,0,15000,3000
06/19/25,Food,Beverages,Oolong Tea,1,6000,6000,0,5000,1000
06/19/25,Food,Beverages,Soda,3,5000,15000,0,12000,3000
06/20/25,Food,Food,Takoyaki,3,10000,30000,0,24000,6000
06/20/25,Food,Food,Steak,4,60000,240000,0,220000,20000
06/20/25,Food,Food,Rendang,1,10000,10000,0,8000,2000
06/20/25,Food,Food,Fried Chicken,10,3000,30000,0,20000,10000
06/20/25,Food,Food,Noodles,8,6000,48000,0,40000,8000
06/20/25,Food,Food,Salmon,4,15000,60000,0,56000,4000
06/20/25,Food,Food,Macaroni,1,5000,5000,0,4000,1000
06/20/25,Food,Food,Fish & Chips,3,30000,90000,0,81000,9000
06/20/25,Food,Food,Burger,2,15000,30000,0,28000,2000
06/20/25,Food,Food,Hotdog,3,10000,30000,0,27000,3000
06/20/25,Food,Food,Pasta,1,18000,18000,0,16000,2000
06/20/25,Food,Snack,Chips,2,5000,10000,0,8000,2000
06/20/25,Food,Snack,Popcorn,1,7000,7000,0,6500,500
06/20/25,Food,Snack,Almonds,1,8000,8000,0,7000,1000
06/20/25,Food,Beverages,Lemon Tea,5,4000,20000,0,15000,5000
06/20/25,Food,Beverages,Ocha,2,4000,8000,0,7000,1000
06/20/25,Food,Beverages,Lychee Tea,3,6000,18000,0,15000,3000
06/20/25,Food,Beverages,Oolong Tea,1,6000,6000,0,5000,1000
06/20/25,Food,Beverages,Soda,3,5000,15000,0,12000,3000
06/21/25,Food,Food,Takoyaki,3,10000,30000,0,24000,6000
06/21/25,Food,Food,Steak,4,60000,240000,0,220000,20000
06/21/25,Food,Food,Rendang,1,10000,10000,0,8000,2000
06/21/25,Food,Food,Fried Chicken,10,3000,30000,0,20000,10000
06/21/25,Food,Food,Noodles,8,6000,48000,0,40000,8000
06/21/25,Food,Food,Salmon,4,15000,60000,0,56000,4000
06/21/25,Food,Food,Macaroni,1,5000,5000,0,4000,1000
06/21/25,Food,Food,Fish & Chips,3,30000,90000,0,81000,9000
06/21/25,Food,Food,Burger,2,15000,30000,0,28000,2000
06/21/25,Food,Food,Hotdog,3,10000,30000,0,27000,3000
06/21/25,Food,Food,Pasta,1,18000,18000,0,16000,2000
06/21/25,Food,Snack,Chips,2,5000,10000,0,8000,2000
06/21/25,Food,Snack,Popcorn,1,7000,7000,0,6500,500
06/21/25,Food,Snack,Almonds,1,8000,8000,0,7000,1000
06/21/25,Food,Beverages,Lemon Tea,5,4000,20000,0,15000,5000
06/21/25,Food,Beverages,Ocha,2,4000,8000,0,7000,1000
06/21/25,Food,Beverages,Lychee Tea,3,6000,18000,0,15000,3000
06/21/25,Food,Beverages,Oolong Tea,1,6000,6000,0,5000,1000
06/21/25,Food,Beverages,Soda,3,5000,15000,0,12000,3000
06/22/25,Food,Food,Takoyaki,3,10000,30000,0,24000,6000
06/22/25,Food,Food,Steak,4,60000,240000,0,220000,20000
06/22/25,Food,Food,Rendang,1,10000,10000,0,8000,2000
06/22/25,Food,Food,Fried Chicken,10,3000,30000,0,20000,10000
06/22/25,Food,Food,Noodles,8,6000,48000,0,40000,8000
06/22/25,Food,Food,Salmon,4,15000,60000,0,56000,4000
06/22/25,Food,Food,Macaroni,1,5000,5000,0,4000,1000
06/22/25,Food,Food,Fish & Chips,3,30000,90000,0,81000,9000
06/22/25,Food,Food,Burger,2,15000,30000,0,28000,2000
06/22/25,Food,Food,Hotdog,3,10000,30000,0,27000,3000
06/22/25,Food,Food,Pasta,1,18000,18000,0,16000,2000
06/22/25,Food,Snack,Chips,2,5000,10000,0,8000,2000
06/22/25,Food,Snack,Popcorn,1,7000,7000,0,6500,500
06/22/25,Food,Snack,Almonds,1,8000,8000,0,7000,1000
06/22/25,Food,Beverages,Lemon Tea,5,4000,20000,0,15000,5000
06/22/25,Food,Beverages,Ocha,2,4000,8000,0,7000,1000
06/22/25,Food,Beverages,Lychee Tea,3,6000,18000,0,15000,3000
06/22/25,Food,Beverages,Oolong Tea,1,6000,6000,0,5000,1000
06/22/25,Food,Beverages,Soda,3,5000,15000,0,12000,3000
06/23/25,Food,Food,Takoyaki,3,10000,30000,0,24000,6000
06/23/25,Food,Food,Steak,4,60000,240000,0,220000,20000
06/23/25,Food,Food,Rendang,1,10000,10000,0,8000,2000
06/23/25,Food,Food,Fried Chicken,10,3000,30000,0,20000,10000
06/23/25,Food,Food,Noodles,8,6000,48000,0,40000,8000
06/23/25,Food,Food,Salmon,4,15000,60000,0,56000,4000
06/23/25,Food,Food,Macaroni,1,5000,5000,0,4000,1000
06/23/25,Food,Food,Fish & Chips,3,30000,90000,0,81000,9000
06/23/25,Food,Food,Burger,2,15000,30000,0,28000,2000
06/23/25,Food,Food,Hotdog,3,10000,30000,0,27000,3000
06/23/25,Food,Food,Pasta,1,18000,18000,0,16000,2000
06/23/25,Food,Snack,Chips,2,5000,10000,0,8000,2000
06/23/25,Food,Snack,Popcorn,1,7000,7000,0,6500,500
06/23/25,Food,Snack,Almonds,1,8000,8000,0,7000,1000
06/23/25,Food,Beverages,Lemon Tea,5,4000,20000,0,15000,5000
06/23/25,Food,Beverages,Ocha,2,4000,8000,0,7000,1000
06/23/25,Food,Beverages,Lychee Tea,3,6000,18000,0,15000,3000
06/23/25,Food,Beverages,Oolong Tea,1,6000,6000,0,5000,1000
06/23/25,Food,Beverages,Soda,3,5000,15000,0,12000,3000
06/24/25,Food,Food,Takoyaki,3,10000,30000,0,24000,6000
06/24/25,Food,Food,Steak,4,60000,240000,0,220000,20000
06/24/25,Food,Food,Rendang,1,10000,10000,0,8000,2000
06/24/25,Food,Food,Fried Chicken,10,3000,30000,0,20000,10000
06/24/25,Food,Food,Noodles,8,6000,48000,0,40000,8000
06/24/25,Food,Food,Salmon,4,15000,60000,0,56000,4000
06/24/25,Food,Food,Macaroni,1,5000,5000,0,4000,1000
06/24/25,Food,Food,Fish & Chips,3,30000,90000,0,81000,9000
06/24/25,Food,Food,Burger,2,15000,30000,0,28000,2000
06/24/25,Food,Food,Hotdog,3,10000,30000,0,27000,3000
06/24/25,Food,Food,Pasta,1,18000,18000,0,16000,2000
06/24/25,Food,Snack,Chips,2,5000,10000,0,8000,2000
06/24/25,Food,Snack,Popcorn,1,7000,7000,0,6500,500
06/24/25,Food,Snack,Almonds,1,8000,8000,0,7000,1000
06/24/25,Food,Beverages,Lemon Tea,5,4000,20000,0,15000,5000
06/24/25,Food,Beverages,Ocha,2,4000,8000,0,7000,1000
06/24/25,Food,Beverages,Lychee Tea,3,6000,18000,0,15000,3000
06/24/25,Food,Beverages,Oolong Tea,1,6000,6000,0,5000,1000
06/24/25,Food,Beverages,Soda,3,5000,15000,0,12000,3000
06/25/25,Food,Food,Takoyaki,3,10000,30000,0,24000,6000
06/25/25,Food,Food,Steak,4,60000,240000,0,220000,20000
06/25/25,Food,Food,Rendang,1,10000,10000,0,8000,2000
06/25/25,Food,Food,Fried Chicken,10,3000,30000,0,20000,10000
06/25/25,Food,Food,Noodles,8,6000,48000,0,40000,8000
06/25/25,Food,Food,Salmon,4,15000,60000,0,56000,4000
06/25/25,Food,Food,Macaroni,1,5000,5000,0,4000,1000
06/25/25,Food,Food,Fish & Chips,3,30000,90000,0,81000,9000
06/25/25,Food,Food,Burger,2,15000,30000,0,28000,2000
06/25/25,Food,Food,Hotdog,3,10000,30000,0,27000,3000
06/25/25,Food,Food,Pasta,1,18000,18000,0,16000,2000
06/25/25,Food,Snack,Chips,2,5000,10000,0,8000,2000
06/25/25,Food,Snack,Popcorn,1,7000,7000,0,6500,500
06/25/25,Food,Snack,Almonds,1,8000,8000,0,7000,1000
06/25/25,Food,Beverages,Lemon Tea,5,4000,20000,0,15000,5000
06/25/25,Food,Beverages,Ocha,2,4000,8000,0,7000,1000
06/25/25,Food,Beverages,Lychee Tea,3,6000,18000,0,15000,3000
06/25/25,Food,Beverages,Oolong Tea,1,6000,6000,0,5000,1000
06/25/25,Food,Beverages,Soda,3,5000,15000,0,12000,3000
06/26/25,Food,Food,Takoyaki,3,10000,30000,0,24000,6000
06/26/25,Food,Food,Steak,4,60000,240000,0,220000,20000
06/26/25,Food,Food,Rendang,1,10000,10000,0,8000,2000
06/26/25,Food,Food,Fried Chicken,10,3000,30000,0,20000,10000
06/26/25,Food,Food,Noodles,8,6000,48000,0,40000,8000
06/26/25,Food,Food,Salmon,4,15000,60000,0,56000,4000
06/26/25,Food,Food,Macaroni,1,5000,5000,0,4000,1000
06/26/25,Food,Food,Fish & Chips,3,30000,90000,0,81000,9000
06/26/25,Food,Food,Burger,2,15000,30000,0,28000,2000
06/26/25,Food,Food,Hotdog,3,10000,30000,0,27000,3000
06/26/25,Food,Food,Pasta,1,18000,18000,0,16000,2000
06/26/25,Food,Snack,Chips,2,5000,10000,0,8000,2000
06/26/25,Food,Snack,Popcorn,1,7000,7000,0,6500,500
06/26/25,Food,Snack,Almonds,1,8000,8000,0,7000,1000
06/26/25,Food,Beverages,Lemon Tea,5,4000,20000,0,15000,5000
06/26/25,Food,Beverages,Ocha,2,4000,8000,0,7000,1000
06/26/25,Food,Beverages,Lychee Tea,3,6000,18000,0,15000,3000
06/26/25,Food,Beverages,Oolong Tea,1,6000,6000,0,5000,1000
06/26/25,Food,Beverages,Soda,3,5000,15000,0,12000,3000
06/27/25,Food,Food,Takoyaki,3,10000,30000,0,24000,6000
06/27/25,Food,Food,Steak,4,60000,240000,0,220000,20000
06/27/25,Food,Food,Rendang,1,10000,10000,0,8000,2000
06/27/25,Food,Food,Fried Chicken,10,3000,30000,0,20000,10000
06/27/25,Food,Food,Noodles,8,6000,48000,0,40000,8000
06/27/25,Food,Food,Salmon,4,15000,60000,0,56000,4000
06/27/25,Food,Food,Macaroni,1,5000,5000,0,4000,1000
06/27/25,Food,Food,Fish & Chips,3,30000,90000,0,81000,9000
06/27/25,Food,Food,Burger,2,15000,30000,0,28000,2000
06/27/25,Food,Food,Hotdog,3,10000,30000,0,27000,3000
06/27/25,Food,Food,Pasta,1,18000,18000,0,16000,2000
06/27/25,Food,Snack,Chips,2,5000,10000,0,8000,2000
06/27/25,Food,Snack,Popcorn,1,7000,7000,0,6500,500
06/27/25,Food,Snack,Almonds,1,8000,8000,0,7000,1000
06/27/25,Food,Beverages,Lemon Tea,5,4000,20000,0,15000,5000
06/27/25,Food,Beverages,Ocha,2,4000,8000,0,7000,1000
06/27/25,Food,Beverages,Lychee Tea,3,6000,18000,0,15000,3000
06/27/25,Food,Beverages,Oolong Tea,1,6000,6000,0,5000,1000
06/27/25,Food,Beverages,Soda,3,5000,15000,0,12000,3000
06/28/25,Food,Food,Takoyaki,3,10000,30000,0,24000,6000
06/28/25,Food,Food,Steak,4,60000,240000,0,220000,20000
06/28/25,Food,Food,Rendang,1,10000,10000,0,8000,2000
06/28/25,Food,Food,Fried Chicken,10,3000,30000,0,20000,10000
06/28/25,Food,Food,Noodles,8,6000,48000,0,40000,8000
06/28/25,Food,Food,Salmon,4,15000,60000,0,56000,4000
06/28/25,Food,Food,Macaroni,1,5000,5000,0,4000,1000
06/28/25,Food,Food,Fish & Chips,3,30000,90000,0,81000,9000
06/28/25,Food,Food,Burger,2,15000,30000,0,28000,2000
06/28/25,Food,Food,Hotdog,3,10000,30000,0,27000,3000
06/28/25,Food,Food,Pasta,1,18000,18000,0,16000,2000
06/28/25,Food,Snack,Chips,2,5000,10000,0,8000,2000
06/28/25,Food,Snack,Popcorn,1,7000,7000,0,6500,500
06/28/25,Food,Snack,Almonds,1,8000,8000,0,7000,1000
06/28/25,Food,Beverages,Lemon Tea,5,4000,20000,0,15000,5000
06/28/25,Food,Beverages,Ocha,2,4000,8000,0,7000,1000
06/28/25,Food,Beverages,Lychee Tea,3,6000,18000,0,15000,3000
06/28/25,Food,Beverages,Oolong Tea,1,6000,6000,0,5000,1000
06/28/25,Food,Beverages,Soda,3,5000,15000,0,12000,3000
06/29/25,Food,Food,Takoyaki,3,10000,30000,0,24000,6000
06/29/25,Food,Food,Steak,4,60000,240000,0,220000,20000
06/29/25,Food,Food,Rendang,1,10000,10000,0,8000,2000
06/29/25,Food,Food,Fried Chicken,10,3000,30000,0,20000,10000
06/29/25,Food,Food,Noodles,8,6000,48000,0,40000,8000
06/29/25,Food,Food,Salmon,4,15000,60000,0,56000,4000
06/29/25,Food,Food,Macaroni,1,5000,5000,0,4000,1000
06/29/25,Food,Food,Fish & Chips,3,30000,90000,0,81000,9000
06/29/25,Food,Food,Burger,2,15000,30000,0,28000,2000
06/29/25,Food,Food,Hotdog,3,10000,30000,0,27000,3000
06/29/25,Food,Food,Pasta,1,18000,18000,0,16000,2000
06/29/25,Food,Snack,Chips,2,5000,10000,0,8000,2000
06/29/25,Food,Snack,Popcorn,1,7000,7000,0,6500,500
06/29/25,Food,Snack,Almonds,1,8000,8000,0,7000,1000
06/29/25,Food,Beverages,Lemon Tea,5,4000,20000,0,15000,5000
06/29/25,Food,Beverages,Ocha,2,4000,8000,0,7000,1000
06/29/25,Food,Beverages,Lychee Tea,3,6000,18000,0,15000,3000
06/29/25,Food,Beverages,Oolong Tea,1,6000,6000,0,5000,1000
06/29/25,Food,Beverages,Soda,3,5000,15000,0,12000,3000
06/30/25,Food,Food,Takoyaki,3,10000,30000,0,24000,6000
06/30/25,Food,Food,Steak,4,60000,240000,0,220000,20000
06/30/25,Food,Food,Rendang,1,10000,10000,0,8000,2000
06/30/25,Food,Food,Fried Chicken,10,3000,30000,0,20000,10000
06/30/25,Food,Food,Noodles,8,6000,48000,0,40000,8000
06/30/25,Food,Food,Salmon,4,15000,60000,0,56000,4000
06/30/25,Food,Food,Macaroni,1,5000,5000,0,4000,1000
06/30/25,Food,Food,Fish & Chips,3,30000,90000,0,81000,9000
06/30/25,Food,Food,Burger,2,15000,30000,0,28000,2000
06/30/25,Food,Food,Hotdog,3,10000,30000,0,27000,3000
06/30/25,Food,Food,Pasta,1,18000,18000,0,16000,2000
06/30/25,Food,Snack,Chips,2,5000,10000,0,8000,2000
06/30/25,Food,Snack,Popcorn,1,7000,7000,0,6500,500
06/30/25,Food,Snack,Almonds,1,8000,8000,0,7000,1000
06/30/25,Food,Beverages,Lemon Tea,5,4000,20000,0,15000,5000
06/30/25,Food,Beverages,Ocha,2,4000,8000,0,7000,1000
06/30/25,Food,Beverages,Lychee Tea,3,6000,18000,0,15000,3000
06/30/25,Food,Beverages,Oolong Tea,1,6000,6000,0,5000,1000
06/30/25,Food,Beverages,Soda,3,5000,15000,0,12000,3000
07/01/25,Food,Food,Takoyaki,3,10000,30000,0,24000,6000
07/01/25,Food,Food,Steak,4,60000,240000,0,220000,20000
07/01/25,Food,Food,Rendang,1,10000,10000,0,8000,2000
07/01/25,Food,Food,Fried Chicken,10,3000,30000,0,20000,10000
07/01/25,Food,Food,Noodles,8,6000,48000,0,40000,8000
07/01/25,Food,Food,Salmon,4,15000,60000,0,56000,4000
07/01/25,Food,Food,Macaroni,1,5000,5000,0,4000,1000
07/01/25,Food,Food,Fish & Chips,3,30000,90000,0,81000,9000
07/01/25,Food,Food,Burger,2,15000,30000,0,28000,2000
07/01/25,Food,Food,Hotdog,3,10000,30000,0,27000,3000
07/01/25,Food,Food,Pasta,1,18000,18000,0,16000,2000
07/01/25,Food,Snack,Chips,2,5000,10000,0,8000,2000
07/01/25,Food,Snack,Popcorn,1,7000,7000,0,6500,500
07/01/25,Food,Snack,Almonds,1,8000,8000,0,7000,1000
07/01/25,Food,Beverages,Lemon Tea,5,4000,20000,0,15000,5000
07/01/25,Food,Beverages,Ocha,2,4000,8000,0,7000,1000
07/01/25,Food,Beverages,Lychee Tea,3,6000,18000,0,15000,3000
07/01/25,Food,Beverages,Oolong Tea,1,6000,6000,0,5000,1000
07/01/25,Food,Beverages,Soda,3,5000,15000,0,12000,3000
07/02/25,Food,Food,Takoyaki,3,10000,30000,0,24000,6000
07/02/25,Food,Food,Steak,4,60000,240000,0,220000,20000
07/02/25,Food,Food,Rendang,1,10000,10000,0,8000,2000
07/02/25,Food,Food,Fried Chicken,10,3000,30000,0,20000,10000
07/02/25,Food,Food,Noodles,8,6000,48000,0,40000,8000
07/02/25,Food,Food,Salmon,4,15000,60000,0,56000,4000
07/02/25,Food,Food,Macaroni,1,5000,5000,0,4000,1000
07/02/25,Food,Food,Fish & Chips,3,30000,90000,0,81000,9000
07/02/25,Food,Food,Burger,2,15000,30000,0,28000,2000
07/02/25,Food,Food,Hotdog,3,10000,30000,0,27000,3000
07/02/25,Food,Food,Pasta,1,18000,18000,0,16000,2000
07/02/25,Food,Snack,Chips,2,5000,10000,0,8000,2000
07/02/25,Food,Snack,Popcorn,1,7000,7000,0,6500,500
07/02/25,Food,Snack,Almonds,1,8000,8000,0,7000,1000
07/02/25,Food,Beverages,Lemon Tea,5,4000,20000,0,15000,5000
07/02/25,Food,Beverages,Ocha,2,4000,8000,0,7000,1000
07/02/25,Food,Beverages,Lychee Tea,3,6000,18000,0,15000,3000
07/02/25,Food,Beverages,Oolong Tea,1,6000,6000,0,5000,1000
07/02/25,Food,Beverages,Soda,3,5000,15000,0,12000,3000
07/03/25,Food,Food,Takoyaki,3,10000,30000,0,24000,6000
07/03/25,Food,Food,Steak,4,60000,240000,0,220000,20000
07/03/25,Food,Food,Rendang,1,10000,10000,0,8000,2000
07/03/25,Food,Food,Fried Chicken,10,3000,30000,0,20000,10000
07/03/25,Food,Food,Noodles,8,6000,48000,0,40000,8000
07/03/25,Food,Food,Salmon,4,15000,60000,0,56000,4000
07/03/25,Food,Food,Macaroni,1,5000,5000,0,4000,1000
07/03/25,Food,Food,Fish & Chips,3,30000,90000,0,81000,9000
07/03/25,Food,Food,Burger,2,15000,30000,0,28000,2000
07/03/25,Food,Food,Hotdog,3,10000,30000,0,27000,3000
07/03/25,Food,Food,Pasta,1,18000,18000,0,16000,2000
07/03/25,Food,Snack,Chips,2,5000,10000,0,8000,2000
07/03/25,Food,Snack,Popcorn,1,7000,7000,0,6500,500
07/03/25,Food,Snack,Almonds,1,8000,8000,0,7000,1000
07/03/25,Food,Beverages,Lemon Tea,5,4000,20000,0,15000,5000
07/03/25,Food,Beverages,Ocha,2,4000,8000,0,7000,1000
07/03/25,Food,Beverages,Lychee Tea,3,6000,18000,0,15000,3000
07/03/25,Food,Beverages,Oolong Tea,1,6000,6000,0,5000,1000
07/03/25,Food,Beverages,Soda,3,5000,15000,0,12000,3000
07/04/25,Food,Food,Takoyaki,3,10000,30000,0,24000,6000
07/04/25,Food,Food,Steak,4,60000,240000,0,220000,20000
07/04/25,Food,Food,Rendang,1,10000,10000,0,8000,2000
07/04/25,Food,Food,Fried Chicken,10,3000,30000,0,20000,10000
07/04/25,Food,Food,Noodles,8,6000,48000,0,40000,8000
07/04/25,Food,Food,Salmon,4,15000,60000,0,56000,4000
07/04/25,Food,Food,Macaroni,1,5000,5000,0,4000,1000
07/04/25,Food,Food,Fish & Chips,3,30000,90000,0,81000,9000
07/04/25,Food,Food,Burger,2,15000,30000,0,28000,2000
07/04/25,Food,Food,Hotdog,3,10000,30000,0,27000,3000
07/04/25,Food,Food,Pasta,1,18000,18000,0,16000,2000
07/04/25,Food,Snack,Chips,2,5000,10000,0,8000,2000
07/04/25,Food,Snack,Popcorn,1,7000,7000,0,6500,500
07/04/25,Food,Snack,Almonds,1,8000,8000,0,7000,1000
07/04/25,Food,Beverages,Lemon Tea,5,4000,20000,0,15000,5000
07/04/25,Food,Beverages,Ocha,2,4000,8000,0,7000,1000
07/04/25,Food,Beverages,Lychee Tea,3,6000,18000,0,15000,3000
07/04/25,Food,Beverages,Oolong Tea,1,6000,6000,0,5000,1000
07/04/25,Food,Beverages,Soda,3,5000,15000,0,12000,3000
07/05/25,Food,Food,Takoyaki,3,10000,30000,0,24000,6000
07/05/25,Food,Food,Steak,4,60000,240000,0,220000,20000
07/05/25,Food,Food,Rendang,1,10000,10000,0,8000,2000
07/05/25,Food,Food,Fried Chicken,10,3000,30000,0,20000,10000
07/05/25,Food,Food,Noodles,8,6000,48000,0,40000,8000
07/05/25,Food,Food,Salmon,4,15000,60000,0,56000,4000
07/05/25,Food,Food,Macaroni,1,5000,5000,0,4000,1000
07/05/25,Food,Food,Fish & Chips,3,30000,90000,0,81000,9000
07/05/25,Food,Food,Burger,2,15000,30000,0,28000,2000
07/05/25,Food,Food,Hotdog,3,10000,30000,0,27000,3000
07/05/25,Food,Food,Pasta,1,18000,18000,0,16000,2000
07/05/25,Food,Snack,Chips,2,5000,10000,0,8000,2000
07/05/25,Food,Snack,Popcorn,1,7000,7000,0,6500,500
07/05/25,Food,Snack,Almonds,1,8000,8000,0,7000,1000
07/05/25,Food,Beverages,Lemon Tea,5,4000,20000,0,15000,5000
07/05/25,Food,Beverages,Ocha,2,4000,8000,0,7000,1000
07/05/25,Food,Beverages,Lychee Tea,3,6000,18000,0,15000,3000
07/05/25,Food,Beverages,Oolong Tea,1,6000,6000,0,5000,1000
07/05/25,Food,Beverages,Soda,3,5000,15000,0,12000,3000
07/06/25,Food,Food,Takoyaki,3,10000,30000,0,24000,6000
07/06/25,Food,Food,Steak,4,60000,240000,0,220000,20000
07/06/25,Food,Food,Rendang,1,10000,10000,0,8000,2000
07/06/25,Food,Food,Fried Chicken,10,3000,30000,0,20000,10000
07/06/25,Food,Food,Noodles,8,6000,48000,0,40000,8000
07/06/25,Food,Food,Salmon,4,15000,60000,0,56000,4000
07/06/25,Food,Food,Macaroni,1,5000,5000,0,4000,1000
07/06/25,Food,Food,Fish & Chips,3,30000,90000,0,81000,9000
07/06/25,Food,Food,Burger,2,15000,30000,0,28000,2000
07/06/25,Food,Food,Hotdog,3,10000,30000,0,27000,3000
07/06/25,Food,Food,Pasta,1,18000,18000,0,16000,2000
07/06/25,Food,Snack,Chips,2,5000,10000,0,8000,2000
07/06/25,Food,Snack,Popcorn,1,7000,7000,0,6500,500
07/06/25,Food,Snack,Almonds,1,8000,8000,0,7000,1000
07/06/25,Food,Beverages,Lemon Tea,5,4000,20000,0,15000,5000
07/06/25,Food,Beverages,Ocha,2,4000,8000,0,7000,1000
07/06/25,Food,Beverages,Lychee Tea,3,6000,18000,0,15000,3000
07/06/25,Food,Beverages,Oolong Tea,1,6000,6000,0,5000,1000
07/06/25,Food,Beverages,Soda,3,5000,15000,0,12000,3000
07/07/25,Food,Food,Takoyaki,3,10000,30000,0,24000,6000
07/07/25,Food,Food,Steak,4,60000,240000,0,220000,20000
07/07/25,Food,Food,Rendang,1,10000,10000,0,8000,2000
07/07/25,Food,Food,Fried Chicken,10,3000,30000,0,20000,10000
07/07/25,Food,Food,Noodles,8,6000,48000,0,40000,8000
07/07/25,Food,Food,Salmon,4,15000,60000,0,56000,4000
07/07/25,Food,Food,Macaroni,1,5000,5000,0,4000,1000
07/07/25,Food,Food,Fish & Chips,3,30000,90000,0,81000,9000
07/07/25,Food,Food,Burger,2,15000,30000,0,28000,2000
07/07/25,Food,Food,Hotdog,3,10000,30000,0,27000,3000
07/07/25,Food,Food,Pasta,1,18000,18000,0,16000,2000
07/07/25,Food,Snack,Chips,2,5000,10000,0,8000,2000
07/07/25,Food,Snack,Popcorn,1,7000,7000,0,6500,500
07/07/25,Food,Snack,Almonds,1,8000,8000,0,7000,1000
07/07/25,Food,Beverages,Lemon Tea,5,4000,20000,0,15000,5000
07/07/25,Food,Beverages,Ocha,2,4000,8000,0,7000,1000
07/07/25,Food,Beverages,Lychee Tea,3,6000,18000,0,15000,3000
07/07/25,Food,Beverages,Oolong Tea,1,6000,6000,0,5000,1000
07/07/25,Food,Beverages,Soda,3,5000,15000,0,12000,3000
07/08/25,Food,Food,Takoyaki,3,10000,30000,0,24000,6000
07/08/25,Food,Food,Steak,4,60000,240000,0,220000,20000
07/08/25,Food,Food,Rendang,1,10000,10000,0,8000,2000
07/08/25,Food,Food,Fried Chicken,10,3000,30000,0,20000,10000
07/08/25,Food,Food,Noodles,8,6000,48000,0,40000,8000
07/08/25,Food,Food,Salmon,4,15000,60000,0,56000,4000
07/08/25,Food,Food,Macaroni,1,5000,5000,0,4000,1000
07/08/25,Food,Food,Fish & Chips,3,30000,90000,0,81000,9000
07/08/25,Food,Food,Burger,2,15000,30000,0,28000,2000
07/08/25,Food,Food,Hotdog,3,10000,30000,0,27000,3000
07/08/25,Food,Food,Pasta,1,18000,18000,0,16000,2000
07/08/25,Food,Snack,Chips,2,5000,10000,0,8000,2000
07/08/25,Food,Snack,Popcorn,1,7000,7000,0,6500,500
07/08/25,Food,Snack,Almonds,1,8000,8000,0,7000,1000
07/08/25,Food,Beverages,Lemon Tea,5,4000,20000,0,15000,5000
07/08/25,Food,Beverages,Ocha,2,4000,8000,0,7000,1000
07/08/25,Food,Beverages,Lychee Tea,3,6000,18000,0,15000,3000
07/08/25,Food,Beverages,Oolong Tea,1,6000,6000,0,5000,1000
07/08/25,Food,Beverages,Soda,3,5000,15000,0,12000,3000
07/09/25,Food,Food,Takoyaki,3,10000,30000,0,24000,6000
07/09/25,Food,Food,Steak,4,60000,240000,0,220000,20000
07/09/25,Food,Food,Rendang,1,10000,10000,0,8000,2000
07/09/25,Food,Food,Fried Chicken,10,3000,30000,0,20000,10000
07/09/25,Food,Food,Noodles,8,6000,48000,0,40000,8000
07/09/25,Food,Food,Salmon,4,15000,60000,0,56000,4000
07/09/25,Food,Food,Macaroni,1,5000,5000,0,4000,1000
07/09/25,Food,Food,Fish & Chips,3,30000,90000,0,81000,9000
07/09/25,Food,Food,Burger,2,15000,30000,0,28000,2000
07/09/25,Food,Food,Hotdog,3,10000,30000,0,27000,3000
07/09/25,Food,Food,Pasta,1,18000,18000,0,16000,2000
07/09/25,Food,Snack,Chips,2,5000,10000,0,8000,2000
07/09/25,Food,Snack,Popcorn,1,7000,7000,0,6500,500
07/09/25,Food,Snack,Almonds,1,8000,8000,0,7000,1000
07/09/25,Food,Beverages,Lemon Tea,5,4000,20000,0,15000,5000
07/09/25,Food,Beverages,Ocha,2,4000,8000,0,7000,1000
07/09/25,Food,Beverages,Lychee Tea,3,6000,18000,0,15000,3000
07/09/25,Food,Beverages,Oolong Tea,1,6000,6000,0,5000,1000
07/09/25,Food,Beverages,Soda,3,5000,15000,0,12000,3000
07/10/25,Food,Food,Takoyaki,3,10000,30000,0,24000,6000
07/10/25,Food,Food,Steak,4,60000,240000,0,220000,20000
07/10/25,Food,Food,Rendang,1,10000,10000,0,8000,2000
07/10/25,Food,Food,Fried Chicken,10,3000,30000,0,20000,10000
07/10/25,Food,Food,Noodles,8,6000,48000,0,40000,8000
07/10/25,Food,Food,Salmon,4,15000,60000,0,56000,4000
07/10/25,Food,Food,Macaroni,1,5000,5000,0,4000,1000
07/10/25,Food,Food,Fish & Chips,3,30000,90000,0,81000,9000
07/10/25,Food,Food,Burger,2,15000,30000,0,28000,2000
07/10/25,Food,Food,Hotdog,3,10000,30000,0,27000,3000
07/10/25,Food,Food,Pasta,1,18000,18000,0,16000,2000
07/10/25,Food,Snack,Chips,2,5000,10000,0,8000,2000
07/10/25,Food,Snack,Popcorn,1,7000,7000,0,6500,500
07/10/25,Food,Snack,Almonds,1,8000,8000,0,7000,1000
07/10/25,Food,Beverages,Lemon Tea,5,4000,20000,0,15000,5000
07/10/25,Food,Beverages,Ocha,2,4000,8000,0,7000,1000
07/10/25,Food,Beverages,Lychee Tea,3,6000,18000,0,15000,3000
07/10/25,Food,Beverages,Oolong Tea,1,6000,6000,0,5000,1000
07/10/25,Food,Beverages,Soda,3,5000,15000,0,12000,3000
07/11/25,Food,Food,Takoyaki,3,10000,30000,0,24000,6000
07/11/25,Food,Food,Steak,4,60000,240000,0,220000,20000
07/11/25,Food,Food,Rendang,1,10000,10000,0,8000,2000
07/11/25,Food,Food,Fried Chicken,10,3000,30000,0,20000,10000
07/11/25,Food,Food,Noodles,8,6000,48000,0,40000,8000
07/11/25,Food,Food,Salmon,4,15000,60000,0,56000,4000
07/11/25,Food,Food,Macaroni,1,5000,5000,0,4000,1000
07/11/25,Food,Food,Fish & Chips,3,30000,90000,0,81000,9000
07/11/25,Food,Food,Burger,2,15000,30000,0,28000,2000
07/11/25,Food,Food,Hotdog,3,10000,30000,0,27000,3000
07/11/25,Food,Food,Pasta,1,18000,18000,0,16000,2000
07/11/25,Food,Snack,Chips,2,5000,10000,0,8000,2000
07/11/25,Food,Snack,Popcorn,1,7000,7000,0,6500,500
07/11/25,Food,Snack,Almonds,1,8000,8000,0,7000,1000
07/11/25,Food,Beverages,Lemon Tea,5,4000,20000,0,15000,5000
07/11/25,Food,Beverages,Ocha,2,4000,8000,0,7000,1000
07/11/25,Food,Beverages,Lychee Tea,3,6000,18000,0,15000,3000
07/11/25,Food,Beverages,Oolong Tea,1,6000,6000,0,5000,1000
07/11/25,Food,Beverages,Soda,3,5000,15000,0,12000,3000
07/12/25,Food,Food,Takoyaki,3,10000,30000,0,24000,6000
07/12/25,Food,Food,Steak,4,60000,240000,0,220000,20000
07/12/25,Food,Food,Rendang,1,10000,10000,0,8000,2000
07/12/25,Food,Food,Fried Chicken,10,3000,30000,0,20000,10000
07/12/25,Food,Food,Noodles,8,6000,48000,0,40000,8000
07/12/25,Food,Food,Salmon,4,15000,60000,0,56000,4000
07/12/25,Food,Food,Macaroni,1,5000,5000,0,4000,1000
07/12/25,Food,Food,Fish & Chips,3,30000,90000,0,81000,9000
07/12/25,Food,Food,Burger,2,15000,30000,0,28000,2000
07/12/25,Food,Food,Hotdog,3,10000,30000,0,27000,3000
07/12/25,Food,Food,Pasta,1,18000,18000,0,16000,2000
07/12/25,Food,Snack,Chips,2,5000,10000,0,8000,2000
07/12/25,Food,Snack,Popcorn,1,7000,7000,0,6500,500
07/12/25,Food,Snack,Almonds,1,8000,8000,0,7000,1000
07/12/25,Food,Beverages,Lemon Tea,5,4000,20000,0,15000,5000
07/12/25,Food,Beverages,Ocha,2,4000,8000,0,7000,1000
07/12/25,Food,Beverages,Lychee Tea,3,6000,18000,0,15000,3000
07/12/25,Food,Beverages,Oolong Tea,1,6000,6000,0,5000,1000
07/12/25,Food,Beverages,Soda,3,5000,15000,0,12000,3000
07/13/25,Food,Food,Takoyaki,3,10000,30000,0,24000,6000
07/13/25,Food,Food,Steak,4,60000,240000,0,220000,20000
07/13/25,Food,Food,Rendang,1,10000,10000,0,8000,2000
07/13/25,Food,Food,Fried Chicken,10,3000,30000,0,20000,10000
07/13/25,Food,Food,Noodles,8,6000,48000,0,40000,8000
07/13/25,Food,Food,Salmon,4,15000,60000,0,56000,4000
07/13/25,Food,Food,Macaroni,1,5000,5000,0,4000,1000
07/13/25,Food,Food,Fish & Chips,3,30000,90000,0,81000,9000
07/13/25,Food,Food,Burger,2,15000,30000,0,28000,2000
07/13/25,Food,Food,Hotdog,3,10000,30000,0,27000,3000
07/13/25,Food,Food,Pasta,1,18000,18000,0,16000,2000
07/13/25,Food,Snack,Chips,2,5000,10000,0,8000,2000
07/13/25,Food,Snack,Popcorn,1,7000,7000,0,6500,500
07/13/25,Food,Snack,Almonds,1,8000,8000,0,7000,1000
07/13/25,Food,Beverages,Lemon Tea,5,4000,20000,0,15000,5000
07/13/25,Food,Beverages,Ocha,2,4000,8000,0,7000,1000
07/13/25,Food,Beverages,Lychee Tea,3,6000,18000,0,15000,3000
07/13/25,Food,Beverages,Oolong Tea,1,6000,6000,0,5000,1000
07/13/25,Food,Beverages,Soda,3,5000,15000,0,12000,3000
07/14/25,Food,Food,Takoyaki,3,10000,30000,0,24000,6000
07/14/25,Food,Food,Steak,4,60000,240000,0,220000,20000
07/14/25,Food,Food,Rendang,1,10000,10000,0,8000,2000
07/14/25,Food,Food,Fried Chicken,10,3000,30000,0,20000,10000
07/14/25,Food,Food,Noodles,8,6000,48000,0,40000,8000
07/14/25,Food,Food,Salmon,4,15000,60000,0,56000,4000
07/14/25,Food,Food,Macaroni,1,5000,5000,0,4000,1000
07/14/25,Food,Food,Fish & Chips,3,30000,90000,0,81000,9000
07/14/25,Food,Food,Burger,2,15000,30000,0,28000,2000
07/14/25,Food,Food,Hotdog,3,10000,30000,0,27000,3000
07/14/25,Food,Food,Pasta,1,18000,18000,0,16000,2000
07/14/25,Food,Snack,Chips,2,5000,10000,0,8000,2000
07/14/25,Food,Snack,Popcorn,1,7000,7000,0,6500,500
07/14/25,Food,Snack,Almonds,1,8000,8000,0,7000,1000
07/14/25,Food,Beverages,Lemon Tea,5,4000,20000,0,15000,5000
07/14/25,Food,Beverages,Ocha,2,4000,8000,0,7000,1000
07/14/25,Food,Beverages,Lychee Tea,3,6000,18000,0,15000,3000
07/14/25,Food,Beverages,Oolong Tea,1,6000,6000,0,5000,1000
07/14/25,Food,Beverages,Soda,3,5000,15000,0,12000,3000
07/15/25,Food,Food,Takoyaki,3,10000,30000,0,24000,6000
07/15/25,Food,Food,Steak,4,60000,240000,0,220000,20000
07/15/25,Food,Food,Rendang,1,10000,10000,0,8000,2000
07/15/25,Food,Food,Fried Chicken,10,3000,30000,0,20000,10000
07/15/25,Food,Food,Noodles,8,6000,48000,0,40000,8000
07/15/25,Food,Food,Salmon,4,15000,60000,0,56000,4000
07/15/25,Food,Food,Macaroni,1,5000,5000,0,4000,1000
07/15/25,Food,Food,Fish & Chips,3,30000,90000,0,81000,9000
07/15/25,Food,Food,Burger,2,15000,30000,0,28000,2000
07/15/25,Food,Food,Hotdog,3,10000,30000,0,27000,3000
07/15/25,Food,Food,Pasta,1,18000,18000,0,16000,2000
07/15/25,Food,Snack,Chips,2,5000,10000,0,8000,2000
07/15/25,Food,Snack,Popcorn,1,7000,7000,0,6500,500
07/15/25,Food,Snack,Almonds,1,8000,8000,0,7000,1000
07/15/25,Food,Beverages,Lemon Tea,5,4000,20000,0,15000,5000
07/15/25,Food,Beverages,Ocha,2,4000,8000,0,7000,1000
07/15/25,Food,Beverages,Lychee Tea,3,6000,18000,0,15000,3000
07/15/25,Food,Beverages,Oolong Tea,1,6000,6000,0,5000,1000
07/15/25,Food,Beverages,Soda,3,5000,15000,0,12000,3000
07/16/25,Food,Food,Takoyaki,3,10000,30000,0,24000,6000
07/16/25,Food,Food,Steak,4,60000,240000,0,220000,20000
07/16/25,Food,Food,Rendang,1,10000,10000,0,8000,2000
07/16/25,Food,Food,Fried Chicken,10,3000,30000,0,20000,10000
07/16/25,Food,Food,Noodles,8,6000,48000,0,40000,8000
07/16/25,Food,Food,Salmon,4,15000,60000,0,56000,4000
07/16/25,Food,Food,Macaroni,1,5000,5000,0,4000,1000
07/16/25,Food,Food,Fish & Chips,3,30000,90000,0,81000,9000
07/16/25,Food,Food,Burger,2,15000,30000,0,28000,2000
07/16/25,Food,Food,Hotdog,3,10000,30000,0,27000,3000
07/16/25,Food,Food,Pasta,1,18000,18000,0,16000,2000
07/16/25,Food,Snack,Chips,2,5000,10000,0,8000,2000
07/16/25,Food,Snack,Popcorn,1,7000,7000,0,6500,500
07/16/25,Food,Snack,Almonds,1,8000,8000,0,7000,1000
07/16/25,Food,Beverages,Lemon Tea,5,4000,20000,0,15000,5000
07/16/25,Food,Beverages,Ocha,2,4000,8000,0,7000,1000
07/16/25,Food,Beverages,Lychee Tea,3,6000,18000,0,15000,3000
07/16/25,Food,Beverages,Oolong Tea,1,6000,6000,0,5000,1000
07/16/25,Food,Beverages,Soda,3,5000,15000,0,12000,3000
07/17/25,Food,Food,Takoyaki,3,10000,30000,0,24000,6000
07/17/25,Food,Food,Steak,4,60000,240000,0,220000,20000
07/17/25,Food,Food,Rendang,1,10000,10000,0,8000,2000
07/17/25,Food,Food,Fried Chicken,10,3000,30000,0,20000,10000
07/17/25,Food,Food,Noodles,8,6000,48000,0,40000,8000
07/17/25,Food,Food,Salmon,4,15000,60000,0,56000,4000
07/17/25,Food,Food,Macaroni,1,5000,5000,0,4000,1000
07/17/25,Food,Food,Fish & Chips,3,30000,90000,0,81000,9000
07/17/25,Food,Food,Burger,2,15000,30000,0,28000,2000
07/17/25,Food,Food,Hotdog,3,10000,30000,0,27000,3000
07/17/25,Food,Food,Pasta,1,18000,18000,0,16000,2000
07/17/25,Food,Snack,Chips,2,5000,10000,0,8000,2000
07/17/25,Food,Snack,Popcorn,1,7000,7000,0,6500,500
07/17/25,Food,Snack,Almonds,1,8000,8000,0,7000,1000
07/17/25,Food,Beverages,Lemon Tea,5,4000,20000,0,15000,5000
07/17/25,Food,Beverages,Ocha,2,4000,8000,0,7000,1000
07/17/25,Food,Beverages,Lychee Tea,3,6000,18000,0,15000,3000
07/17/25,Food,Beverages,Oolong Tea,1,6000,6000,0,5000,1000
07/17/25,Food,Beverages,Soda,3,5000,15000,0,12000,3000
07/18/25,Food,Food,Takoyaki,3,10000,30000,0,24000,6000
07/18/25,Food,Food,Steak,4,60000,240000,0,220000,20000
07/18/25,Food,Food,Rendang,1,10000,10000,0,8000,2000
07/18/25,Food,Food,Fried Chicken,10,3000,30000,0,20000,10000
07/18/25,Food,Food,Noodles,8,6000,48000,0,40000,8000
07/18/25,Food,Food,Salmon,4,15000,60000,0,56000,4000
07/18/25,Food,Food,Macaroni,1,5000,5000,0,4000,1000
07/18/25,Food,Food,Fish & Chips,3,30000,90000,0,81000,9000
07/18/25,Food,Food,Burger,2,15000,30000,0,28000,2000
07/18/25,Food,Food,Hotdog,3,10000,30000,0,27000,3000
07/18/25,Food,Food,Pasta,1,18000,18000,0,16000,2000
07/18/25,Food,Snack,Chips,2,5000,10000,0,8000,2000
07/18/25,Food,Snack,Popcorn,1,7000,7000,0,6500,500
07/18/25,Food,Snack,Almonds,1,8000,8000,0,7000,1000
07/18/25,Food,Beverages,Lemon Tea,5,4000,20000,0,15000,5000
07/18/25,Food,Beverages,Ocha,2,4000,8000,0,7000,1000
07/18/25,Food,Beverages,Lychee Tea,3,6000,18000,0,15000,3000
07/18/25,Food,Beverages,Oolong Tea,1,6000,6000,0,5000,1000
07/18/25,Food,Beverages,Soda,3,5000,15000,0,12000,3000
07/19/25,Food,Food,Takoyaki,3,10000,30000,0,24000,6000
07/19/25,Food,Food,Steak,4,60000,240000,0,220000,20000
07/19/25,Food,Food,Rendang,1,10000,10000,0,8000,2000
07/19/25,Food,Food,Fried Chicken,10,3000,30000,0,20000,10000
07/19/25,Food,Food,Noodles,8,6000,48000,0,40000,8000
07/19/25,Food,Food,Salmon,4,15000,60000,0,56000,4000
07/19/25,Food,Food,Macaroni,1,5000,5000,0,4000,1000
07/19/25,Food,Food,Fish & Chips,3,30000,90000,0,81000,9000
07/19/25,Food,Food,Burger,2,15000,30000,0,28000,2000
07/19/25,Food,Food,Hotdog,3,10000,30000,0,27000,3000
07/19/25,Food,Food,Pasta,1,18000,18000,0,16000,2000
07/19/25,Food,Snack,Chips,2,5000,10000,0,8000,2000
07/19/25,Food,Snack,Popcorn,1,7000,7000,0,6500,500
07/19/25,Food,Snack,Almonds,1,8000,8000,0,7000,1000
07/19/25,Food,Beverages,Lemon Tea,5,4000,20000,0,15000,5000
07/19/25,Food,Beverages,Ocha,2,4000,8000,0,7000,1000
07/19/25,Food,Beverages,Lychee Tea,3,6000,18000,0,15000,3000
07/19/25,Food,Beverages,Oolong Tea,1,6000,6000,0,5000,1000
07/19/25,Food,Beverages,Soda,3,5000,15000,0,12000,3000
07/20/25,Food,Food,Takoyaki,3,10000,30000,0,24000,6000
07/20/25,Food,Food,Steak,4,60000,240000,0,220000,20000
07/20/25,Food,Food,Rendang,1,10000,10000,0,8000,2000
07/20/25,Food,Food,Fried Chicken,10,3000,30000,0,20000,10000
07/20/25,Food,Food,Noodles,8,6000,48000,0,40000,8000
07/20/25,Food,Food,Salmon,4,15000,60000,0,56000,4000
07/20/25,Food,Food,Macaroni,1,5000,5000,0,4000,1000
07/20/25,Food,Food,Fish & Chips,3,30000,90000,0,81000,9000
07/20/25,Food,Food,Burger,2,15000,30000,0,28000,2000
07/20/25,Food,Food,Hotdog,3,10000,30000,0,27000,3000
07/20/25,Food,Food,Pasta,1,18000,18000,0,16000,2000
07/20/25,Food,Snack,Chips,2,5000,10000,0,8000,2000
07/20/25,Food,Snack,Popcorn,1,7000,7000,0,6500,500
07/20/25,Food,Snack,Almonds,1,8000,8000,0,7000,1000
07/20/25,Food,Beverages,Lemon Tea,5,4000,20000,0,15000,5000
07/20/25,Food,Beverages,Ocha,2,4000,8000,0,7000,1000
07/20/25,Food,Beverages,Lychee Tea,3,6000,18000,0,15000,3000
07/20/25,Food,Beverages,Oolong Tea,1,6000,6000,0,5000,1000
<<<<<<< HEAD
07/20/25,Food,Beverages,Soda,3,5000,15000,0,12000,3000
=======
07/20/25,Food,Beverages,Soda,3,5000,15000,0,12000,3000
>>>>>>> 751f5bd4b30e9ad87c5287085e62cbb408c1627f
